cell	Cell_type
i3_intact_S1_bcAAJM	Epidermal_Langerhans
i3_intact_S1_bcAALG	Intermediate_epidermis
i3_intact_S1_bcAALL	Fibroblast
i3_intact_S1_bcABGZ	Intermediate_epidermis
i3_intact_S1_bcABPH	Myeloid
i3_intact_S1_bcACJN	Myeloid
i3_intact_S1_bcACJV	Intermediate_epidermis
i3_intact_S1_bcACPB	Myeloid
i3_intact_S1_bcACSE	Erythrocyte
i3_intact_S1_bcAERD	Intermediate_epidermis
i3_intact_S1_bcAETM	Early_B
i3_intact_S1_bcAEWR	Intermediate_epidermis
i3_intact_S1_bcAFFG	Erythrocyte
i3_intact_S1_bcAFMP	Intermediate_epidermis
i3_intact_S1_bcAGCQ	SSCs
i3_intact_S1_bcAGDY	Myeloid
i3_intact_S1_bcAGKG	Intermediate_epidermis
i3_intact_S1_bcAGLK	SSCs
i3_intact_S1_bcAGPK	Erythrocyte
i3_intact_S1_bcAGUI	Proliferating_Epidermis
i3_intact_S1_bcAGXO	Intermediate_epidermis
i3_intact_S1_bcAGYK	Proliferating_Epidermis
i3_intact_S1_bcAGYO	Intermediate_epidermis
i3_intact_S1_bcAHBF	Erythrocyte
i3_intact_S1_bcAHHS	Intermediate_epidermis
i3_intact_S1_bcAHNW	Intermediate_epidermis
i3_intact_S1_bcAHTT	Intermediate_epidermis
i3_intact_S1_bcAHZL	Tcells
i3_intact_S1_bcAICF	Erythrocyte
i3_intact_S1_bcAIRK	Proliferating_Epidermis
i3_intact_S1_bcAIXQ	Intermediate_epidermis
i3_intact_S1_bcAIXY	Intermediate_epidermis
i3_intact_S1_bcAJBW	Epidermal_Langerhans
i3_intact_S1_bcAJEQ	Intermediate_epidermis
i3_intact_S1_bcAJPG	Intermediate_epidermis
i3_intact_S1_bcAJSP	Erythrocyte
i3_intact_S1_bcAJWG	Intermediate_epidermis
i3_intact_S1_bcAKFB	SSCs
i3_intact_S1_bcAKMB	Intermediate_epidermis
i3_intact_S1_bcAKRX	SSCs
i3_intact_S1_bcAKWO	Intermediate_epidermis
i3_intact_S1_bcALFH	Intermediate_epidermis
i3_intact_S1_bcALKD	Proliferating_Epidermis
i3_intact_S1_bcALME	Intermediate_epidermis
i3_intact_S1_bcALNS	Intermediate_epidermis
i3_intact_S1_bcALXB	Erythrocyte
i3_intact_S1_bcAMXC	Intermediate_epidermis
i3_intact_S1_bcANIR	Myeloid
i3_intact_S1_bcANXE	Tcells
i3_intact_S1_bcAOMQ	Intermediate_epidermis
i3_intact_S1_bcAOOU	Intermediate_epidermis
i3_intact_S1_bcAOTM	Proliferating_Epidermis
i3_intact_S1_bcAOYZ	Intermediate_epidermis
i3_intact_S1_bcAPFK	Intermediate_epidermis
i3_intact_S1_bcAPKK	SSCs
i3_intact_S1_bcAPMA	Intermediate_epidermis
i3_intact_S1_bcAPPK	Intermediate_epidermis
i3_intact_S1_bcAPUY	SSCs
i3_intact_S1_bcAPZE	Intermediate_epidermis
i3_intact_S1_bcAPZX	BasalEpidermis
i3_intact_S1_bcAQAQ	Intermediate_epidermis
i3_intact_S1_bcAQBV	Proliferating_Epidermis
i3_intact_S1_bcAQBY	Proliferating_Epidermis
i3_intact_S1_bcAQHA	Erythrocyte
i3_intact_S1_bcAQMF	Intermediate_epidermis
i3_intact_S1_bcAQPJ	Intermediate_epidermis
i3_intact_S1_bcARCG	Proliferating_Epidermis
i3_intact_S1_bcARDZ	BasalEpidermis
i3_intact_S1_bcARED	SSCs
i3_intact_S1_bcARXC	Myeloid
i3_intact_S1_bcASCO	Intermediate_epidermis
i3_intact_S1_bcASNZ	Intermediate_epidermis
i3_intact_S1_bcASRB	Intermediate_epidermis
i3_intact_S1_bcASTM	Intermediate_epidermis
i3_intact_S1_bcASWT	Proliferating_Epidermis
i3_intact_S1_bcATDO	Intermediate_epidermis
i3_intact_S1_bcATJB	Erythrocyte
i3_intact_S1_bcATLG	Intermediate_epidermis
i3_intact_S1_bcATMK	Myeloid
i3_intact_S1_bcATXQ	Proliferating_Epidermis
i3_intact_S1_bcATZB	Erythrocyte
i3_intact_S1_bcAUDG	Intermediate_epidermis
i3_intact_S1_bcAUEG	Intermediate_epidermis
i3_intact_S1_bcAUKS	Myeloid
i3_intact_S1_bcAUNL	Tcells
i3_intact_S1_bcAUZH	Intermediate_epidermis
i3_intact_S1_bcAVEU	SSCs
i3_intact_S1_bcAVPV	Intermediate_epidermis
i3_intact_S1_bcAVPW	Intermediate_epidermis
i3_intact_S1_bcAWAJ	Intermediate_epidermis
i3_intact_S1_bcAWGG	Intermediate_epidermis
i3_intact_S1_bcAWXB	SSCs
i3_intact_S1_bcAWYJ	Erythrocyte
i3_intact_S1_bcAWYT	SSCs
i3_intact_S1_bcAXCZ	Intermediate_epidermis
i3_intact_S1_bcAXVF	Tcells
i3_intact_S1_bcAYGE	Epidermal_Langerhans
i3_intact_S1_bcAYHE	Tcells
i3_intact_S1_bcAYNK	SSCs
i3_intact_S1_bcAYVJ	Intermediate_epidermis
i3_intact_S1_bcAZER	Intermediate_epidermis
i3_intact_S1_bcAZQV	Erythrocyte
i3_intact_S1_bcAZSX	Intermediate_epidermis
i3_intact_S1_bcBADT	Erythrocyte
i3_intact_S1_bcBAEJ	Erythrocyte
i3_intact_S1_bcBAOI	Intermediate_epidermis
i3_intact_S1_bcBAUC	Intermediate_epidermis
i3_intact_S1_bcBAWC	Intermediate_epidermis
i3_intact_S1_bcBBPV	Fibroblast
i3_intact_S1_bcBBRZ	Intermediate_epidermis
i3_intact_S1_bcBCAA	Intermediate_epidermis
i3_intact_S1_bcBCGU	Intermediate_epidermis
i3_intact_S1_bcBCMH	Intermediate_epidermis
i3_intact_S1_bcBCSI	Erythrocyte
i3_intact_S1_bcBCVH	Fibroblast
i3_intact_S1_bcBCWP	SSCs
i3_intact_S1_bcBCZT	Proliferating_Epidermis
i3_intact_S1_bcBDFC	Intermediate_epidermis
i3_intact_S1_bcBDQR	Tcells
i3_intact_S1_bcBDRC	BasalEpidermis
i3_intact_S1_bcBDST	Intermediate_epidermis
i3_intact_S1_bcBDTX	Intermediate_epidermis
i3_intact_S1_bcBEBM	Myeloid
i3_intact_S1_bcBECB	Erythrocyte
i3_intact_S1_bcBECF	Intermediate_epidermis
i3_intact_S1_bcBEGA	SSCs
i3_intact_S1_bcBEHA	Intermediate_epidermis
i3_intact_S1_bcBEJJ	Intermediate_epidermis
i3_intact_S1_bcBEPN	Intermediate_epidermis
i3_intact_S1_bcBFER	Proliferating_Epidermis
i3_intact_S1_bcBFIS	SSCs
i3_intact_S1_bcBFKI	Ionocytes
i3_intact_S1_bcBFKR	Intermediate_epidermis
i3_intact_S1_bcBFXD	Myeloid
i3_intact_S1_bcBFYW	Myeloid
i3_intact_S1_bcBFZF	Proliferating_Epidermis
i3_intact_S1_bcBGET	Proliferating_Epidermis
i3_intact_S1_bcBHDE	Tcells
i3_intact_S1_bcBHJL	Intermediate_epidermis
i3_intact_S1_bcBHOW	Intermediate_epidermis
i3_intact_S1_bcBHWY	Tcells
i3_intact_S1_bcBHYG	Intermediate_epidermis
i3_intact_S1_bcBIGS	Intermediate_epidermis
i3_intact_S1_bcBINK	Intermediate_epidermis
i3_intact_S1_bcBITR	Intermediate_epidermis
i3_intact_S1_bcBJZQ	Erythrocyte
i3_intact_S1_bcBKNX	Intermediate_epidermis
i3_intact_S1_bcBKRL	SSCs
i3_intact_S1_bcBLDG	Intermediate_epidermis
i3_intact_S1_bcBLZQ	Intermediate_epidermis
i3_intact_S1_bcBMEF	Myeloid
i3_intact_S1_bcBMGB	Proliferating_Epidermis
i3_intact_S1_bcBMTA	Intermediate_epidermis
i3_intact_S1_bcBNBM	Intermediate_epidermis
i3_intact_S1_bcBNVZ	Intermediate_epidermis
i3_intact_S1_bcBNXT	SSCs
i3_intact_S1_bcBOJD	Erythrocyte
i3_intact_S1_bcBOLE	Intermediate_epidermis
i3_intact_S1_bcBONQ	Tcells
i3_intact_S1_bcBOVL	Erythrocyte
i3_intact_S1_bcBPNC	SSCs
i3_intact_S1_bcBPUC	Intermediate_epidermis
i3_intact_S1_bcBPWK	Intermediate_epidermis
i3_intact_S1_bcBPYC	Intermediate_epidermis
i3_intact_S1_bcBQWR	Intermediate_epidermis
i3_intact_S1_bcBQXD	Intermediate_epidermis
i3_intact_S1_bcBQYZ	Proliferating_Epidermis
i3_intact_S1_bcBRTM	Intermediate_epidermis
i3_intact_S1_bcBRUS	Intermediate_epidermis
i3_intact_S1_bcBRXJ	Intermediate_epidermis
i3_intact_S1_bcBSBZ	Intermediate_epidermis
i3_intact_S1_bcBSEF	SSCs
i3_intact_S1_bcBSEP	Intermediate_epidermis
i3_intact_S1_bcBSOW	SSCs
i3_intact_S1_bcBSPS	Proliferating_Epidermis
i3_intact_S1_bcBSPU	Erythrocyte
i3_intact_S1_bcBSRD	BasalEpidermis
i3_intact_S1_bcBSZX	Tcells
i3_intact_S1_bcBTMN	Proliferating_Epidermis
i3_intact_S1_bcBTOQ	Ionocytes
i3_intact_S1_bcBUDU	Intermediate_epidermis
i3_intact_S1_bcBUMA	Erythrocyte
i3_intact_S1_bcBUVE	Intermediate_epidermis
i3_intact_S1_bcBUZA	SSCs
i3_intact_S1_bcBVNA	Intermediate_epidermis
i3_intact_S1_bcBVOD	Intermediate_epidermis
i3_intact_S1_bcBWAH	SSCs
i3_intact_S1_bcBWDA	Intermediate_epidermis
i3_intact_S1_bcBWIC	Tcells
i3_intact_S1_bcBWRP	Intermediate_epidermis
i3_intact_S1_bcBWSK	Early_B
i3_intact_S1_bcBWZV	Intermediate_epidermis
i3_intact_S1_bcBXBI	Intermediate_epidermis
i3_intact_S1_bcBXCS	Intermediate_epidermis
i3_intact_S1_bcBXDC	Tcells
i3_intact_S1_bcBXHJ	SSCs
i3_intact_S1_bcBYAY	Proliferating_Epidermis
i3_intact_S1_bcBYKJ	Tcells
i3_intact_S1_bcBYLF	Early_B
i3_intact_S1_bcBYOR	Fibroblast
i3_intact_S1_bcBYRN	SSCs
i3_intact_S1_bcBYTA	Intermediate_epidermis
i3_intact_S1_bcBYUI	Proliferating_Epidermis
i3_intact_S1_bcBZKV	Intermediate_epidermis
i3_intact_S1_bcBZMX	Intermediate_epidermis
i3_intact_S1_bcBZTE	Proliferating_Epidermis
i3_intact_S1_bcBZWD	Erythrocyte
i3_intact_S1_bcCAAX	Intermediate_epidermis
i3_intact_S1_bcCAFI	Intermediate_epidermis
i3_intact_S1_bcCAIZ	Intermediate_epidermis
i3_intact_S1_bcCASW	BasalEpidermis
i3_intact_S1_bcCAVG	Intermediate_epidermis
i3_intact_S1_bcCAVU	Intermediate_epidermis
i3_intact_S1_bcCAYB	SSCs
i3_intact_S1_bcCBEM	Intermediate_epidermis
i3_intact_S1_bcCBFA	Intermediate_epidermis
i3_intact_S1_bcCBYD	Intermediate_epidermis
i3_intact_S1_bcCCFZ	Intermediate_epidermis
i3_intact_S1_bcCCOA	Intermediate_epidermis
i3_intact_S1_bcCCOC	Proliferating_Epidermis
i3_intact_S1_bcCDEH	Intermediate_epidermis
i3_intact_S1_bcCDNH	SSCs
i3_intact_S1_bcCDQC	Erythrocyte
i3_intact_S1_bcCDSZ	Intermediate_epidermis
i3_intact_S1_bcCDVN	Tcells
i3_intact_S1_bcCDYK	Ionocytes
i3_intact_S1_bcCEBQ	Erythrocyte
i3_intact_S1_bcCEFG	Proliferating_Epidermis
i3_intact_S1_bcCELA	Tcells
i3_intact_S1_bcCEQS	Proliferating_Epidermis
i3_intact_S1_bcCETL	Intermediate_epidermis
i3_intact_S1_bcCETP	Intermediate_epidermis
i3_intact_S1_bcCFIQ	Intermediate_epidermis
i3_intact_S1_bcCFML	Ionocytes
i3_intact_S1_bcCFTX	Intermediate_epidermis
i3_intact_S1_bcCFYC	Erythrocyte
i3_intact_S1_bcCGAR	Erythrocyte
i3_intact_S1_bcCGHG	Intermediate_epidermis
i3_intact_S1_bcCGON	Intermediate_epidermis
i3_intact_S1_bcCGRH	Intermediate_epidermis
i3_intact_S1_bcCHFK	Myeloid
i3_intact_S1_bcCHSS	Proliferating_Epidermis
i3_intact_S1_bcCHUN	Myeloid
i3_intact_S1_bcCHYO	Intermediate_epidermis
i3_intact_S1_bcCIJD	Intermediate_epidermis
i3_intact_S1_bcCIVC	Proliferating_Epidermis
i3_intact_S1_bcCIXV	SSCs
i3_intact_S1_bcCJMM	Proliferating_Epidermis
i3_intact_S1_bcCJTC	Proliferating_Epidermis
i3_intact_S1_bcCJVC	Intermediate_epidermis
i3_intact_S1_bcCJVX	Intermediate_epidermis
i3_intact_S1_bcCKMK	Intermediate_epidermis
i3_intact_S1_bcCKPC	Proliferating_Epidermis
i3_intact_S1_bcCKQW	Intermediate_epidermis
i3_intact_S1_bcCLAR	Intermediate_epidermis
i3_intact_S1_bcCLFQ	Intermediate_epidermis
i3_intact_S1_bcCLFX	Epidermal_Langerhans
i3_intact_S1_bcCLLL	Erythrocyte
i3_intact_S1_bcCLRU	Early_B
i3_intact_S1_bcCLSQ	Intermediate_epidermis
i3_intact_S1_bcCLTH	Intermediate_epidermis
i3_intact_S1_bcCMTS	Erythrocyte
i3_intact_S1_bcCMWB	Erythrocyte
i3_intact_S1_bcCNDN	Epidermal_Langerhans
i3_intact_S1_bcCNZL	Intermediate_epidermis
i3_intact_S1_bcCOGX	SSCs
i3_intact_S1_bcCOJD	SSCs
i3_intact_S1_bcCOSK	Myeloid
i3_intact_S1_bcCOWI	Erythrocyte
i3_intact_S1_bcCOXC	SSCs
i3_intact_S1_bcCOYX	Intermediate_epidermis
i3_intact_S1_bcCPDN	SSCs
i3_intact_S1_bcCPLN	Intermediate_epidermis
i3_intact_S1_bcCPYO	Intermediate_epidermis
i3_intact_S1_bcCQBL	Fibroblast
i3_intact_S1_bcCQEA	Intermediate_epidermis
i3_intact_S1_bcCQHJ	Intermediate_epidermis
i3_intact_S1_bcCQOB	Intermediate_epidermis
i3_intact_S1_bcCQPW	SSCs
i3_intact_S1_bcCQRC	Proliferating_Epidermis
i3_intact_S1_bcCRBL	Intermediate_epidermis
i3_intact_S1_bcCREC	Ionocytes
i3_intact_S1_bcCRLU	Intermediate_epidermis
i3_intact_S1_bcCRMM	Intermediate_epidermis
i3_intact_S1_bcCRVV	Intermediate_epidermis
i3_intact_S1_bcCRWV	SSCs
i3_intact_S1_bcCRXI	Intermediate_epidermis
i3_intact_S1_bcCRXQ	Intermediate_epidermis
i3_intact_S1_bcCRXW	BasalEpidermis
i3_intact_S1_bcCSFD	SSCs
i3_intact_S1_bcCSFU	Intermediate_epidermis
i3_intact_S1_bcCSLQ	Intermediate_epidermis
i3_intact_S1_bcCTIJ	Proliferating_Epidermis
i3_intact_S1_bcCTNN	Intermediate_epidermis
i3_intact_S1_bcCTQE	Intermediate_epidermis
i3_intact_S1_bcCTVX	Intermediate_epidermis
i3_intact_S1_bcCTYI	Intermediate_epidermis
i3_intact_S1_bcCUDG	Intermediate_epidermis
i3_intact_S1_bcCUDL	Intermediate_epidermis
i3_intact_S1_bcCUDS	Myeloid
i3_intact_S1_bcCUFB	Erythrocyte
i3_intact_S1_bcCUFX	Erythrocyte
i3_intact_S1_bcCUOM	Tcells
i3_intact_S1_bcCURL	Erythrocyte
i3_intact_S1_bcCUTZ	Intermediate_epidermis
i3_intact_S1_bcCUVI	Intermediate_epidermis
i3_intact_S1_bcCUZI	Early_B
i3_intact_S1_bcCVBK	Intermediate_epidermis
i3_intact_S1_bcCVKO	Erythrocyte
i3_intact_S1_bcCVOS	Intermediate_epidermis
i3_intact_S1_bcCVXV	SSCs
i3_intact_S1_bcCVYZ	Ionocytes
i3_intact_S1_bcCWGC	Intermediate_epidermis
i3_intact_S1_bcCWIK	Myeloid
i3_intact_S1_bcCWUM	Intermediate_epidermis
i3_intact_S1_bcCXIC	Fibroblast
i3_intact_S1_bcCXQH	Intermediate_epidermis
i3_intact_S1_bcCXYV	SSCs
i3_intact_S1_bcCXZT	Intermediate_epidermis
i3_intact_S1_bcCYDV	Intermediate_epidermis
i3_intact_S1_bcCYEF	Intermediate_epidermis
i3_intact_S1_bcCYMS	Intermediate_epidermis
i3_intact_S1_bcCYNL	Intermediate_epidermis
i3_intact_S1_bcCYRD	Intermediate_epidermis
i3_intact_S1_bcCZDQ	Intermediate_epidermis
i3_intact_S1_bcCZGM	Intermediate_epidermis
i3_intact_S1_bcCZVL	Tcells
i3_intact_S1_bcDABD	Intermediate_epidermis
i3_intact_S1_bcDAGS	Intermediate_epidermis
i3_intact_S1_bcDAIM	Intermediate_epidermis
i3_intact_S1_bcDAJA	Erythrocyte
i3_intact_S1_bcDANV	Intermediate_epidermis
i3_intact_S1_bcDAPK	Intermediate_epidermis
i3_intact_S1_bcDAQM	Intermediate_epidermis
i3_intact_S1_bcDARR	Erythrocyte
i3_intact_S1_bcDATU	Tcells
i3_intact_S1_bcDBAE	Tcells
i3_intact_S1_bcDBBG	Proliferating_Epidermis
i3_intact_S1_bcDBDN	Intermediate_epidermis
i3_intact_S1_bcDBJL	SSCs
i3_intact_S1_bcDBLF	SSCs
i3_intact_S1_bcDBNO	Intermediate_epidermis
i3_intact_S1_bcDBQD	BasalEpidermis
i3_intact_S1_bcDBRS	Intermediate_epidermis
i3_intact_S1_bcDBYD	SSCs
i3_intact_S1_bcDBZR	Proliferating_Epidermis
i3_intact_S1_bcDBZZ	BasalEpidermis
i3_intact_S1_bcDCEZ	Intermediate_epidermis
i3_intact_S1_bcDCJH	Intermediate_epidermis
i3_intact_S1_bcDCJS	Erythrocyte
i3_intact_S1_bcDCLM	Erythrocyte
i3_intact_S1_bcDCMP	SSCs
i3_intact_S1_bcDCPQ	Proliferating_Epidermis
i3_intact_S1_bcDCQM	Intermediate_epidermis
i3_intact_S1_bcDCVV	Intermediate_epidermis
i3_intact_S1_bcDDCF	Tcells
i3_intact_S1_bcDDHN	Intermediate_epidermis
i3_intact_S1_bcDDJE	SSCs
i3_intact_S1_bcDDKM	BasalEpidermis
i3_intact_S1_bcDDPM	Tcells
i3_intact_S1_bcDDQE	Intermediate_epidermis
i3_intact_S1_bcDEAY	SSCs
i3_intact_S1_bcDEEQ	Intermediate_epidermis
i3_intact_S1_bcDEFE	Intermediate_epidermis
i3_intact_S1_bcDEKV	Intermediate_epidermis
i3_intact_S1_bcDEOU	Intermediate_epidermis
i3_intact_S1_bcDETB	Proliferating_Epidermis
i3_intact_S1_bcDFSH	Tcells
i3_intact_S1_bcDFTE	Intermediate_epidermis
i3_intact_S1_bcDFVX	BasalEpidermis
i3_intact_S1_bcDFXZ	SSCs
i3_intact_S1_bcDGFV	Intermediate_epidermis
i3_intact_S1_bcDGVP	Intermediate_epidermis
i3_intact_S1_bcDGVU	Intermediate_epidermis
i3_intact_S1_bcDGXE	Intermediate_epidermis
i3_intact_S1_bcDHCI	Fibroblast
i3_intact_S1_bcDHDH	SSCs
i3_intact_S1_bcDHVW	Tcells
i3_intact_S1_bcDHXN	Proliferating_Epidermis
i3_intact_S1_bcDIDP	SSCs
i3_intact_S1_bcDIKR	Intermediate_epidermis
i3_intact_S1_bcDIUM	Tcells
i3_intact_S1_bcDJCF	Erythrocyte
i3_intact_S1_bcDJGX	Proliferating_Epidermis
i3_intact_S1_bcDJJH	Tcells
i3_intact_S1_bcDJVR	Intermediate_epidermis
i3_intact_S1_bcDJWE	SSCs
i3_intact_S1_bcDKLP	Intermediate_epidermis
i3_intact_S1_bcDKXI	Intermediate_epidermis
i3_intact_S1_bcDKYF	Intermediate_epidermis
i3_intact_S1_bcDLAD	Intermediate_epidermis
i3_intact_S1_bcDLKV	Fibroblast
i3_intact_S1_bcDLPK	Intermediate_epidermis
i3_intact_S1_bcDLQK	Myeloid
i3_intact_S1_bcDLTJ	Myeloid
i3_intact_S1_bcDLUU	Myeloid
i3_intact_S1_bcDLWN	Intermediate_epidermis
i3_intact_S1_bcDMKI	Intermediate_epidermis
i3_intact_S1_bcDMLD	Proliferating_Epidermis
i3_intact_S1_bcDMLS	SSCs
i3_intact_S1_bcDMMQ	Intermediate_epidermis
i3_intact_S1_bcDMXE	Intermediate_epidermis
i3_intact_S1_bcDNBY	Tcells
i3_intact_S1_bcDNDO	Intermediate_epidermis
i3_intact_S1_bcDNEZ	Erythrocyte
i3_intact_S1_bcDNGI	Myeloid
i3_intact_S1_bcDNGU	Intermediate_epidermis
i3_intact_S1_bcDNJF	Myeloid
i3_intact_S1_bcDNTY	Erythrocyte
i3_intact_S1_bcDNZT	Intermediate_epidermis
i3_intact_S1_bcDOTA	Intermediate_epidermis
i3_intact_S1_bcDOYV	Erythrocyte
i3_intact_S1_bcDPAB	Erythrocyte
i3_intact_S1_bcDPDW	SSCs
i3_intact_S1_bcDPLB	Intermediate_epidermis
i3_intact_S1_bcDPMI	Intermediate_epidermis
i3_intact_S1_bcDPOV	BasalEpidermis
i3_intact_S1_bcDPRB	Intermediate_epidermis
i3_intact_S1_bcDPWB	SSCs
i3_intact_S1_bcDPWM	Intermediate_epidermis
i3_intact_S1_bcDQJF	Erythrocyte
i3_intact_S1_bcDQKZ	Myeloid
i3_intact_S1_bcDQMP	Intermediate_epidermis
i3_intact_S1_bcDQNM	Intermediate_epidermis
i3_intact_S1_bcDQQE	Intermediate_epidermis
i3_intact_S1_bcDQQO	Intermediate_epidermis
i3_intact_S1_bcDQRC	Intermediate_epidermis
i3_intact_S1_bcDQVP	Intermediate_epidermis
i3_intact_S1_bcDRBN	Intermediate_epidermis
i3_intact_S1_bcDRIJ	SSCs
i3_intact_S1_bcDRLF	Tcells
i3_intact_S1_bcDRLJ	Fibroblast
i3_intact_S1_bcDRLT	Intermediate_epidermis
i3_intact_S1_bcDRMB	SSCs
i3_intact_S1_bcDROV	Erythrocyte
i3_intact_S1_bcDROW	SSCs
i3_intact_S1_bcDRVJ	Erythrocyte
i3_intact_S1_bcDSBY	Intermediate_epidermis
i3_intact_S1_bcDSEL	Intermediate_epidermis
i3_intact_S1_bcDSIU	Erythrocyte
i3_intact_S1_bcDSKT	Proliferating_Epidermis
i3_intact_S1_bcDSLA	SSCs
i3_intact_S1_bcDSQR	Erythrocyte
i3_intact_S1_bcDSRO	Myeloid
i3_intact_S1_bcDSTB	SSCs
i3_intact_S1_bcDSTL	Erythrocyte
i3_intact_S1_bcDTXM	Intermediate_epidermis
i3_intact_S1_bcDUHF	Erythrocyte
i3_intact_S1_bcDULB	Myeloid
i3_intact_S1_bcDUSW	Intermediate_epidermis
i3_intact_S1_bcDUYI	Tcells
i3_intact_S1_bcDUYU	Tcells
i3_intact_S1_bcDVFE	Tcells
i3_intact_S1_bcDVNV	Myeloid
i3_intact_S1_bcDVPC	SSCs
i3_intact_S1_bcDWCY	Tcells
i3_intact_S1_bcDWPP	SSCs
i3_intact_S1_bcDWYI	Intermediate_epidermis
i3_intact_S1_bcDXBW	Intermediate_epidermis
i3_intact_S1_bcDXUR	SSCs
i3_intact_S1_bcDXVL	Intermediate_epidermis
i3_intact_S1_bcDXZX	Proliferating_Epidermis
i3_intact_S1_bcDYEC	Intermediate_epidermis
i3_intact_S1_bcDYEI	Proliferating_Epidermis
i3_intact_S1_bcDYGO	Intermediate_epidermis
i3_intact_S1_bcDYMV	Erythrocyte
i3_intact_S1_bcDZKM	Myeloid
i3_intact_S1_bcDZTL	Tcells
i3_intact_S1_bcEAGN	Proliferating_Epidermis
i3_intact_S1_bcEAID	Ionocytes
i3_intact_S1_bcEAQC	Erythrocyte
i3_intact_S1_bcEBDC	Epidermal_Langerhans
i3_intact_S1_bcEBEK	Erythrocyte
i3_intact_S1_bcEBER	Erythrocyte
i3_intact_S1_bcEBJC	Intermediate_epidermis
i3_intact_S1_bcEBOE	Intermediate_epidermis
i3_intact_S1_bcEBYT	Erythrocyte
i3_intact_S1_bcECBQ	Tcells
i3_intact_S1_bcECCE	Intermediate_epidermis
i3_intact_S1_bcECQZ	Erythrocyte
i3_intact_S1_bcECSL	Intermediate_epidermis
i3_intact_S1_bcEDAO	Intermediate_epidermis
i3_intact_S1_bcEDHK	Intermediate_epidermis
i3_intact_S1_bcEDLL	Tcells
i3_intact_S1_bcEDML	Proliferating_Epidermis
i3_intact_S1_bcEDMV	Intermediate_epidermis
i3_intact_S1_bcEEEI	Proliferating_Epidermis
i3_intact_S1_bcEEKF	Erythrocyte
i3_intact_S1_bcEEQS	Intermediate_epidermis
i3_intact_S1_bcEEUX	Intermediate_epidermis
i3_intact_S1_bcEFCS	SSCs
i3_intact_S1_bcEFOM	SSCs
i3_intact_S1_bcEFZS	Intermediate_epidermis
i3_intact_S1_bcEGBH	Intermediate_epidermis
i3_intact_S1_bcEGMG	Tcells
i3_intact_S1_bcEGQN	Proliferating_Epidermis
i3_intact_S1_bcEHDH	Intermediate_epidermis
i3_intact_S1_bcEHKX	Intermediate_epidermis
i3_intact_S1_bcEHLB	Intermediate_epidermis
i3_intact_S1_bcEHMG	Intermediate_epidermis
i3_intact_S1_bcEHOI	Intermediate_epidermis
i3_intact_S1_bcEHXE	Tcells
i3_intact_S1_bcEIIQ	Erythrocyte
i3_intact_S1_bcEJBA	Intermediate_epidermis
i3_intact_S1_bcEJBK	Proliferating_Epidermis
i3_intact_S1_bcEJBQ	Intermediate_epidermis
i3_intact_S1_bcEJDX	SSCs
i3_intact_S1_bcEJQI	Intermediate_epidermis
i3_intact_S1_bcEJSF	Tcells
i3_intact_S1_bcEJXY	Erythrocyte
i3_intact_S1_bcEKZN	Ionocytes
i3_intact_S1_bcELCD	Intermediate_epidermis
i3_intact_S1_bcELDG	Proliferating_Epidermis
i3_intact_S1_bcELOT	Intermediate_epidermis
i3_intact_S1_bcELPB	Intermediate_epidermis
i3_intact_S1_bcELQM	Intermediate_epidermis
i3_intact_S1_bcELTM	Intermediate_epidermis
i3_intact_S1_bcEMBJ	Intermediate_epidermis
i3_intact_S1_bcEMQA	Intermediate_epidermis
i3_intact_S1_bcEMSD	SSCs
i3_intact_S1_bcEMTQ	Intermediate_epidermis
i3_intact_S1_bcENWX	SSCs
i3_intact_S1_bcENZI	Proliferating_Epidermis
i3_intact_S1_bcEOCR	Intermediate_epidermis
i3_intact_S1_bcEOEU	Intermediate_epidermis
i3_intact_S1_bcEOIM	Tcells
i3_intact_S1_bcEOOI	Erythrocyte
i3_intact_S1_bcEPCH	Erythrocyte
i3_intact_S1_bcEPGF	Erythrocyte
i3_intact_S1_bcEPHV	Fibroblast
i3_intact_S1_bcEPSD	Erythrocyte
i3_intact_S1_bcEPYU	Intermediate_epidermis
i3_intact_S1_bcEQEO	Intermediate_epidermis
i3_intact_S1_bcEQJN	Proliferating_Epidermis
i3_intact_S1_bcEQMI	Intermediate_epidermis
i3_intact_S1_bcEQNB	Intermediate_epidermis
i3_intact_S1_bcEQNO	Intermediate_epidermis
i3_intact_S1_bcEQTQ	Myeloid
i3_intact_S1_bcEQVF	Early_B
i3_intact_S1_bcEQZL	Intermediate_epidermis
i3_intact_S1_bcESBT	Intermediate_epidermis
i3_intact_S1_bcESMA	Tcells
i3_intact_S1_bcESMN	Myeloid
i3_intact_S1_bcESNW	Epidermal_Langerhans
i3_intact_S1_bcESTX	Proliferating_Epidermis
i3_intact_S1_bcESVU	Erythrocyte
i3_intact_S1_bcESYN	Tcells
i3_intact_S1_bcETFA	Intermediate_epidermis
i3_intact_S1_bcETJI	Erythrocyte
i3_intact_S1_bcETRN	Tcells
i3_intact_S1_bcEUKF	Intermediate_epidermis
i3_intact_S1_bcEURU	Intermediate_epidermis
i3_intact_S1_bcEUUK	Early_B
i3_intact_S1_bcEUWL	Myeloid
i3_intact_S1_bcEVIK	Proliferating_Epidermis
i3_intact_S1_bcEVKP	Intermediate_epidermis
i3_intact_S1_bcEVLG	Intermediate_epidermis
i3_intact_S1_bcEVOU	Intermediate_epidermis
i3_intact_S1_bcEVPS	Intermediate_epidermis
i3_intact_S1_bcEVQA	Intermediate_epidermis
i3_intact_S1_bcEVRJ	Myeloid
i3_intact_S1_bcEWAZ	Intermediate_epidermis
i3_intact_S1_bcEWDC	Epidermal_Langerhans
i3_intact_S1_bcEWGR	Myeloid
i3_intact_S1_bcEWMJ	Myeloid
i3_intact_S1_bcEWVE	Erythrocyte
i3_intact_S1_bcEWYX	Proliferating_Epidermis
i3_intact_S1_bcEXAZ	Intermediate_epidermis
i3_intact_S1_bcEXCB	Erythrocyte
i3_intact_S1_bcEXDK	BasalEpidermis
i3_intact_S1_bcEXHO	Myeloid
i3_intact_S1_bcEXLO	Intermediate_epidermis
i3_intact_S1_bcEXUW	Intermediate_epidermis
i3_intact_S1_bcEYDT	Tcells
i3_intact_S1_bcEYGN	Intermediate_epidermis
i3_intact_S1_bcEYHH	Intermediate_epidermis
i3_intact_S1_bcEYSY	Intermediate_epidermis
i3_intact_S1_bcEZBZ	Proliferating_Epidermis
i3_intact_S1_bcEZDO	Intermediate_epidermis
i3_intact_S1_bcEZMP	Intermediate_epidermis
i3_intact_S1_bcEZMY	SSCs
i3_intact_S1_bcEZNA	SSCs
i3_intact_S1_bcEZPF	Intermediate_epidermis
i3_intact_S1_bcEZRM	BasalEpidermis
i3_intact_S1_bcEZRU	Erythrocyte
i3_intact_S1_bcEZUX	Tcells
i3_intact_S1_bcEZUZ	Erythrocyte
i3_intact_S1_bcEZWH	Erythrocyte
i3_intact_S1_bcFAAE	Erythrocyte
i3_intact_S1_bcFABW	SSCs
i3_intact_S1_bcFAER	Intermediate_epidermis
i3_intact_S1_bcFAJR	Tcells
i3_intact_S1_bcFAPP	Myeloid
i3_intact_S1_bcFAPQ	Fibroblast
i3_intact_S1_bcFBDJ	Intermediate_epidermis
i3_intact_S1_bcFBDM	Proliferating_Epidermis
i3_intact_S1_bcFBFR	Intermediate_epidermis
i3_intact_S1_bcFBGK	Intermediate_epidermis
i3_intact_S1_bcFBIR	Tcells
i3_intact_S1_bcFBQS	SSCs
i3_intact_S1_bcFBUM	Proliferating_Epidermis
i3_intact_S1_bcFBXC	Intermediate_epidermis
i3_intact_S1_bcFCGP	Epidermal_Langerhans
i3_intact_S1_bcFCKG	SSCs
i3_intact_S1_bcFCSR	BasalEpidermis
i3_intact_S1_bcFDAP	Intermediate_epidermis
i3_intact_S1_bcFDHU	Intermediate_epidermis
i3_intact_S1_bcFDKI	Proliferating_Epidermis
i3_intact_S1_bcFDSG	Intermediate_epidermis
i3_intact_S1_bcFDWJ	Intermediate_epidermis
i3_intact_S1_bcFDYO	SSCs
i3_intact_S1_bcFECU	Intermediate_epidermis
i3_intact_S1_bcFEIX	Intermediate_epidermis
i3_intact_S1_bcFEKB	SSCs
i3_intact_S1_bcFENE	Myeloid
i3_intact_S1_bcFEOK	Fibroblast
i3_intact_S1_bcFEPS	Proliferating_Epidermis
i3_intact_S1_bcFEQW	Tcells
i3_intact_S1_bcFERW	SSCs
i3_intact_S1_bcFESZ	SSCs
i3_intact_S1_bcFEVH	Intermediate_epidermis
i3_intact_S1_bcFEWO	Intermediate_epidermis
i3_intact_S1_bcFEZK	Myeloid
i3_intact_S1_bcFFFZ	Erythrocyte
i3_intact_S1_bcFFNA	Fibroblast
i3_intact_S1_bcFFOX	SSCs
i3_intact_S1_bcFFQS	Intermediate_epidermis
i3_intact_S1_bcFFXA	Early_B
i3_intact_S1_bcFFZT	Myeloid
i3_intact_S1_bcFGHF	Erythrocyte
i3_intact_S1_bcFGNZ	Proliferating_Epidermis
i3_intact_S1_bcFGUL	Intermediate_epidermis
i3_intact_S1_bcFHNO	Intermediate_epidermis
i3_intact_S1_bcFHOL	Intermediate_epidermis
i3_intact_S1_bcFHSP	Intermediate_epidermis
i3_intact_S1_bcFHZD	SSCs
i3_intact_S1_bcFHZN	Intermediate_epidermis
i3_intact_S1_bcFIHR	Intermediate_epidermis
i3_intact_S1_bcFJBA	Erythrocyte
i3_intact_S1_bcFJTW	Intermediate_epidermis
i3_intact_S1_bcFJZL	Tcells
i3_intact_S1_bcFKED	Erythrocyte
i3_intact_S1_bcFKLC	Erythrocyte
i3_intact_S1_bcFKRC	SSCs
i3_intact_S1_bcFKZD	SSCs
i3_intact_S1_bcFLNL	Intermediate_epidermis
i3_intact_S1_bcFLNT	Erythrocyte
i3_intact_S1_bcFLUJ	Tcells
i3_intact_S1_bcFMAU	BasalEpidermis
i3_intact_S1_bcFMBI	Erythrocyte
i3_intact_S1_bcFMKP	Proliferating_Epidermis
i3_intact_S1_bcFMML	Intermediate_epidermis
i3_intact_S1_bcFMTH	Intermediate_epidermis
i3_intact_S1_bcFMTU	SSCs
i3_intact_S1_bcFNAR	Tcells
i3_intact_S1_bcFNDL	Early_B
i3_intact_S1_bcFNPM	Intermediate_epidermis
i3_intact_S1_bcFNWP	Erythrocyte
i3_intact_S1_bcFNZW	Early_B
i3_intact_S1_bcFOAS	Intermediate_epidermis
i3_intact_S1_bcFOKP	Fibroblast
i3_intact_S1_bcFOWO	Myeloid
i3_intact_S1_bcFOYD	Intermediate_epidermis
i3_intact_S1_bcFPGU	Intermediate_epidermis
i3_intact_S1_bcFPIT	Erythrocyte
i3_intact_S1_bcFPLJ	Intermediate_epidermis
i3_intact_S1_bcFPUU	Intermediate_epidermis
i3_intact_S1_bcFQSY	Intermediate_epidermis
i3_intact_S1_bcFQVI	Erythrocyte
i3_intact_S1_bcFRBG	Early_B
i3_intact_S1_bcFRGK	Fibroblast
i3_intact_S1_bcFRKL	Intermediate_epidermis
i3_intact_S1_bcFRRV	Intermediate_epidermis
i3_intact_S1_bcFRSX	SSCs
i3_intact_S1_bcFRUB	Erythrocyte
i3_intact_S1_bcFSBL	SSCs
i3_intact_S1_bcFSDN	Intermediate_epidermis
i3_intact_S1_bcFSJR	Intermediate_epidermis
i3_intact_S1_bcFSVD	Intermediate_epidermis
i3_intact_S1_bcFSWZ	Myeloid
i3_intact_S1_bcFTXU	Myeloid
i3_intact_S1_bcFUBY	SSCs
i3_intact_S1_bcFUJE	Intermediate_epidermis
i3_intact_S1_bcFUJI	Tcells
i3_intact_S1_bcFUKA	Intermediate_epidermis
i3_intact_S1_bcFUNN	Proliferating_Epidermis
i3_intact_S1_bcFUTD	Intermediate_epidermis
i3_intact_S1_bcFVCT	SSCs
i3_intact_S1_bcFVDH	Intermediate_epidermis
i3_intact_S1_bcFVDX	Erythrocyte
i3_intact_S1_bcFVDZ	Erythrocyte
i3_intact_S1_bcFVRQ	Intermediate_epidermis
i3_intact_S1_bcFVSW	SSCs
i3_intact_S1_bcFVWC	Intermediate_epidermis
i3_intact_S1_bcFWNP	Intermediate_epidermis
i3_intact_S1_bcFWPI	Erythrocyte
i3_intact_S1_bcFWSB	Intermediate_epidermis
i3_intact_S1_bcFWSH	Proliferating_Epidermis
i3_intact_S1_bcFWWW	Erythrocyte
i3_intact_S1_bcFXAO	Intermediate_epidermis
i3_intact_S1_bcFXAZ	Proliferating_Epidermis
i3_intact_S1_bcFXEY	Tcells
i3_intact_S1_bcFXKH	Intermediate_epidermis
i3_intact_S1_bcFXMY	Intermediate_epidermis
i3_intact_S1_bcFXXZ	Erythrocyte
i3_intact_S1_bcFYHO	Intermediate_epidermis
i3_intact_S1_bcFYMA	Ionocytes
i3_intact_S1_bcFYMG	SSCs
i3_intact_S1_bcFYPF	Myeloid
i3_intact_S1_bcFZDD	Intermediate_epidermis
i3_intact_S1_bcFZFC	Intermediate_epidermis
i3_intact_S1_bcFZIR	Intermediate_epidermis
i3_intact_S1_bcFZJQ	Intermediate_epidermis
i3_intact_S1_bcFZNR	Intermediate_epidermis
i3_intact_S1_bcFZNS	Intermediate_epidermis
i3_intact_S1_bcFZQS	Intermediate_epidermis
i3_intact_S1_bcFZRV	Intermediate_epidermis
i3_intact_S1_bcFZSA	Intermediate_epidermis
i3_intact_S1_bcFZUJ	Intermediate_epidermis
i3_intact_S1_bcGAAR	Intermediate_epidermis
i3_intact_S1_bcGADS	Intermediate_epidermis
i3_intact_S1_bcGAFG	Erythrocyte
i3_intact_S1_bcGAFV	SSCs
i3_intact_S1_bcGAIX	Intermediate_epidermis
i3_intact_S1_bcGBCE	Intermediate_epidermis
i3_intact_S1_bcGBHL	Tcells
i3_intact_S1_bcGBHW	Intermediate_epidermis
i3_intact_S1_bcGBJY	Intermediate_epidermis
i3_intact_S1_bcGBKW	Tcells
i3_intact_S1_bcGBMX	Erythrocyte
i3_intact_S1_bcGBQN	Intermediate_epidermis
i3_intact_S1_bcGBTK	Tcells
i3_intact_S1_bcGBYX	Intermediate_epidermis
i3_intact_S1_bcGBZH	Myeloid
i3_intact_S1_bcGCBE	Intermediate_epidermis
i3_intact_S1_bcGCGG	Intermediate_epidermis
i3_intact_S1_bcGCYO	Intermediate_epidermis
i3_intact_S1_bcGDCB	SSCs
i3_intact_S1_bcGDCD	Intermediate_epidermis
i3_intact_S1_bcGDEO	Intermediate_epidermis
i3_intact_S1_bcGDIZ	Erythrocyte
i3_intact_S1_bcGDKO	SSCs
i3_intact_S1_bcGDMN	Intermediate_epidermis
i3_intact_S1_bcGDPL	Intermediate_epidermis
i3_intact_S1_bcGDPV	Intermediate_epidermis
i3_intact_S1_bcGDQA	Intermediate_epidermis
i3_intact_S1_bcGDZU	Myeloid
i3_intact_S1_bcGEKF	Intermediate_epidermis
i3_intact_S1_bcGEOB	Intermediate_epidermis
i3_intact_S1_bcGERW	Proliferating_Epidermis
i3_intact_S1_bcGEYN	Erythrocyte
i3_intact_S1_bcGFBW	Tcells
i3_intact_S1_bcGFQZ	Intermediate_epidermis
i3_intact_S1_bcGFVP	Erythrocyte
i3_intact_S1_bcGFYB	Fibroblast
i3_intact_S1_bcGGNG	Erythrocyte
i3_intact_S1_bcGGUY	Intermediate_epidermis
i3_intact_S1_bcGGWB	Intermediate_epidermis
i3_intact_S1_bcGIGV	Intermediate_epidermis
i3_intact_S1_bcGIND	Intermediate_epidermis
i3_intact_S1_bcGIUH	Intermediate_epidermis
i3_intact_S1_bcGIUJ	SSCs
i3_intact_S1_bcGIUL	SSCs
i3_intact_S1_bcGJDD	Erythrocyte
i3_intact_S1_bcGJQJ	Early_B
i3_intact_S1_bcGJUO	Intermediate_epidermis
i3_intact_S1_bcGJVF	Erythrocyte
i3_intact_S1_bcGKDY	Fibroblast
i3_intact_S1_bcGKSI	Tcells
i3_intact_S1_bcGKUX	Intermediate_epidermis
i3_intact_S1_bcGLET	Erythrocyte
i3_intact_S1_bcGLFP	Intermediate_epidermis
i3_intact_S1_bcGLPX	SSCs
i3_intact_S1_bcGLQK	Intermediate_epidermis
i3_intact_S1_bcGLRP	BasalEpidermis
i3_intact_S1_bcGLZL	Intermediate_epidermis
i3_intact_S1_bcGMNH	Tcells
i3_intact_S1_bcGNJY	Erythrocyte
i3_intact_S1_bcGODG	BasalEpidermis
i3_intact_S1_bcGOGG	Proliferating_Epidermis
i3_intact_S1_bcGOIH	Intermediate_epidermis
i3_intact_S1_bcGONR	Intermediate_epidermis
i3_intact_S1_bcGOOP	Erythrocyte
i3_intact_S1_bcGOPF	Proliferating_Epidermis
i3_intact_S1_bcGPBJ	Intermediate_epidermis
i3_intact_S1_bcGPJH	Intermediate_epidermis
i3_intact_S1_bcGPJZ	Intermediate_epidermis
i3_intact_S1_bcGPYY	Intermediate_epidermis
i3_intact_S1_bcGQCF	Erythrocyte
i3_intact_S1_bcGQFF	Tcells
i3_intact_S1_bcGQKD	Intermediate_epidermis
i3_intact_S1_bcGQLY	Intermediate_epidermis
i3_intact_S1_bcGQTJ	Myeloid
i3_intact_S1_bcGQVA	Tcells
i3_intact_S1_bcGQZD	Intermediate_epidermis
i3_intact_S1_bcGRBW	Intermediate_epidermis
i3_intact_S1_bcGRHM	BasalEpidermis
i3_intact_S1_bcGRKC	SSCs
i3_intact_S1_bcGRNZ	Intermediate_epidermis
i3_intact_S1_bcGRSD	Intermediate_epidermis
i3_intact_S1_bcGRVD	Intermediate_epidermis
i3_intact_S1_bcGSDF	Intermediate_epidermis
i3_intact_S1_bcGSEU	Intermediate_epidermis
i3_intact_S1_bcGSLD	Tcells
i3_intact_S1_bcGSYR	Erythrocyte
i3_intact_S1_bcGTGH	Intermediate_epidermis
i3_intact_S1_bcGTOW	Intermediate_epidermis
i3_intact_S1_bcGTRB	Intermediate_epidermis
i3_intact_S1_bcGTVO	Intermediate_epidermis
i3_intact_S1_bcGTYZ	Intermediate_epidermis
i3_intact_S1_bcGUDE	Intermediate_epidermis
i3_intact_S1_bcGUHB	SSCs
i3_intact_S1_bcGUPJ	Erythrocyte
i3_intact_S1_bcGUWJ	Erythrocyte
i3_intact_S1_bcGVGO	Ionocytes
i3_intact_S1_bcGVNN	Tcells
i3_intact_S1_bcGVOP	Proliferating_Epidermis
i3_intact_S1_bcGVWC	Early_B
i3_intact_S1_bcGWAA	Intermediate_epidermis
i3_intact_S1_bcGWBK	Tcells
i3_intact_S1_bcGWHU	Intermediate_epidermis
i3_intact_S1_bcGWHY	Early_B
i3_intact_S1_bcGWJI	Erythrocyte
i3_intact_S1_bcGWRT	Myeloid
i3_intact_S1_bcGWSE	Fibroblast
i3_intact_S1_bcGXCC	Proliferating_Epidermis
i3_intact_S1_bcGXHG	BasalEpidermis
i3_intact_S1_bcGXOT	Intermediate_epidermis
i3_intact_S1_bcGXTY	BasalEpidermis
i3_intact_S1_bcGXVM	Fibroblast
i3_intact_S1_bcGXXH	Proliferating_Epidermis
i3_intact_S1_bcGYMA	Erythrocyte
i3_intact_S1_bcGYOS	Intermediate_epidermis
i3_intact_S1_bcGYQY	SSCs
i3_intact_S1_bcGYYS	Intermediate_epidermis
i3_intact_S1_bcGZEA	Proliferating_Epidermis
i3_intact_S1_bcGZFB	Proliferating_Epidermis
i3_intact_S1_bcGZPH	Tcells
i3_intact_S1_bcGZXG	Intermediate_epidermis
i3_intact_S1_bcHALW	SSCs
i3_intact_S1_bcHAMN	Tcells
i3_intact_S1_bcHAMV	BasalEpidermis
i3_intact_S1_bcHAZP	Intermediate_epidermis
i3_intact_S1_bcHBEG	Intermediate_epidermis
i3_intact_S1_bcHBER	Intermediate_epidermis
i3_intact_S1_bcHBKI	Intermediate_epidermis
i3_intact_S1_bcHBUK	Intermediate_epidermis
i3_intact_S1_bcHBUW	Intermediate_epidermis
i3_intact_S1_bcHBVL	Erythrocyte
i3_intact_S1_bcHBZF	SSCs
i3_intact_S1_bcHCNW	Erythrocyte
i3_intact_S1_bcHDED	SSCs
i3_intact_S1_bcHDHY	Intermediate_epidermis
i3_intact_S1_bcHDNS	Tcells
i3_intact_S1_bcHDOE	Myeloid
i3_intact_S1_bcHDTG	Intermediate_epidermis
i3_intact_S1_bcHDZE	Erythrocyte
i3_intact_S1_bcHDZG	Intermediate_epidermis
i3_intact_S1_bcHDZN	Intermediate_epidermis
i3_intact_S1_bcHEKD	Proliferating_Epidermis
i3_intact_S1_bcHERN	Intermediate_epidermis
i3_intact_S1_bcHFLJ	Intermediate_epidermis
i3_intact_S1_bcHFSB	Intermediate_epidermis
i3_intact_S1_bcHGDY	SSCs
i3_intact_S1_bcHGLA	Intermediate_epidermis
i3_intact_S1_bcHGQB	Proliferating_Epidermis
i3_intact_S1_bcHGUL	Intermediate_epidermis
i3_intact_S1_bcHGYK	Intermediate_epidermis
i3_intact_S1_bcHIDA	Intermediate_epidermis
i3_intact_S1_bcHIHG	SSCs
i3_intact_S1_bcHINZ	Tcells
i3_intact_S1_bcHIYK	Myeloid
i3_intact_S1_bcHJAY	Intermediate_epidermis
i3_intact_S1_bcHJDF	SSCs
i3_intact_S1_bcHJDW	Intermediate_epidermis
i3_intact_S1_bcHJIA	SSCs
i3_intact_S1_bcHJIU	Intermediate_epidermis
i3_intact_S1_bcHJSQ	SSCs
i3_intact_S1_bcHJUW	Fibroblast
i3_intact_S1_bcHJVN	Intermediate_epidermis
i3_intact_S1_bcHJWD	Fibroblast
i3_intact_S1_bcHKAH	SSCs
i3_intact_S1_bcHKCP	Erythrocyte
i3_intact_S1_bcHKNC	Erythrocyte
i3_intact_S1_bcHKQE	Intermediate_epidermis
i3_intact_S1_bcHKVW	Intermediate_epidermis
i3_intact_S1_bcHLGC	Tcells
i3_intact_S1_bcHLNB	SSCs
i3_intact_S1_bcHLNS	Tcells
i3_intact_S1_bcHLYN	Erythrocyte
i3_intact_S1_bcHMAN	Intermediate_epidermis
i3_intact_S1_bcHMJT	Erythrocyte
i3_intact_S1_bcHMOU	SSCs
i3_intact_S1_bcHMRB	SSCs
i3_intact_S1_bcHMRT	Intermediate_epidermis
i3_intact_S1_bcHMVL	Intermediate_epidermis
i3_intact_S1_bcHMWJ	SSCs
i3_intact_S1_bcHMZF	Fibroblast
i3_intact_S1_bcHNPB	Proliferating_Epidermis
i3_intact_S1_bcHNPQ	Intermediate_epidermis
i3_intact_S1_bcHNYZ	Proliferating_Epidermis
i3_intact_S1_bcHOBC	Intermediate_epidermis
i3_intact_S1_bcHODY	Intermediate_epidermis
i3_intact_S1_bcHOTI	Intermediate_epidermis
i3_intact_S1_bcHPMC	Intermediate_epidermis
i3_intact_S1_bcHPMJ	Intermediate_epidermis
i3_intact_S1_bcHPNZ	Tcells
i3_intact_S1_bcHPPP	SSCs
i3_intact_S1_bcHPZA	Intermediate_epidermis
i3_intact_S1_bcHQGQ	SSCs
i3_intact_S1_bcHQKH	SSCs
i3_intact_S1_bcHQXH	Fibroblast
i3_intact_S1_bcHRAT	Intermediate_epidermis
i3_intact_S1_bcHRCA	Intermediate_epidermis
i3_intact_S1_bcHRCE	Fibroblast
i3_intact_S1_bcHRDD	Intermediate_epidermis
i3_intact_S1_bcHRJH	SSCs
i3_intact_S1_bcHRMZ	Erythrocyte
i3_intact_S1_bcHRUN	SSCs
i3_intact_S1_bcHRZM	Tcells
i3_intact_S1_bcHSWB	SSCs
i3_intact_S1_bcHTBX	Erythrocyte
i3_intact_S1_bcHTHM	Erythrocyte
i3_intact_S1_bcHTOJ	Myeloid
i3_intact_S1_bcHTON	SSCs
i3_intact_S1_bcHVJU	Intermediate_epidermis
i3_intact_S1_bcHVKB	Fibroblast
i3_intact_S1_bcHVMY	Intermediate_epidermis
i3_intact_S1_bcHVQV	Proliferating_Epidermis
i3_intact_S1_bcHWEE	Erythrocyte
i3_intact_S1_bcHWMQ	Erythrocyte
i3_intact_S1_bcHWQG	SSCs
i3_intact_S1_bcHXCJ	SSCs
i3_intact_S1_bcHXJF	Intermediate_epidermis
i3_intact_S1_bcHXNR	Myeloid
i3_intact_S1_bcHYIC	Intermediate_epidermis
i3_intact_S1_bcHYJQ	Erythrocyte
i3_intact_S1_bcHYSL	Proliferating_Epidermis
i3_intact_S1_bcHYUE	Myeloid
i3_intact_S1_bcHZDW	Intermediate_epidermis
i3_intact_S1_bcHZFY	Intermediate_epidermis
i3_intact_S1_bcHZKE	Intermediate_epidermis
i3_intact_S1_bcHZSP	Intermediate_epidermis
i3_intact_S1_bcHZYN	Intermediate_epidermis
i3_intact_S1_bcIAFN	SSCs
i3_intact_S1_bcIAGG	Intermediate_epidermis
i3_intact_S1_bcIAMZ	Erythrocyte
i3_intact_S1_bcIANJ	Intermediate_epidermis
i3_intact_S1_bcIAOD	Intermediate_epidermis
i3_intact_S1_bcIASJ	Erythrocyte
i3_intact_S1_bcIAVJ	Fibroblast
i3_intact_S1_bcIAYV	Early_B
i3_intact_S1_bcIBEU	Intermediate_epidermis
i3_intact_S1_bcIBFQ	SSCs
i3_intact_S1_bcIBLK	SSCs
i3_intact_S1_bcIBLV	Intermediate_epidermis
i3_intact_S1_bcICFX	Intermediate_epidermis
i3_intact_S1_bcICQF	Intermediate_epidermis
i3_intact_S1_bcICUM	Tcells
i3_intact_S1_bcICXI	Erythrocyte
i3_intact_S1_bcICYC	Intermediate_epidermis
i3_intact_S1_bcIDDB	Intermediate_epidermis
i3_intact_S1_bcIDGL	Tcells
i3_intact_S1_bcIDOZ	BasalEpidermis
i3_intact_S1_bcIDVB	Intermediate_epidermis
i3_intact_S1_bcIFRE	Proliferating_Epidermis
i3_intact_S1_bcIGDA	Intermediate_epidermis
i3_intact_S1_bcIGHN	Tcells
i3_intact_S1_bcIGUJ	Proliferating_Epidermis
i3_intact_S1_bcIHKS	Intermediate_epidermis
i3_intact_S1_bcIHMD	Intermediate_epidermis
i3_intact_S1_bcIHQT	Intermediate_epidermis
i3_intact_S1_bcIHWE	Intermediate_epidermis
i3_intact_S1_bcIIDO	Intermediate_epidermis
i3_intact_S1_bcIIEL	Proliferating_Epidermis
i3_intact_S1_bcIIHJ	Myeloid
i3_intact_S1_bcIIKG	Intermediate_epidermis
i3_intact_S1_bcIIXB	Erythrocyte
i3_intact_S1_bcIJBN	Intermediate_epidermis
i3_intact_S1_bcIJCT	SSCs
i3_intact_S1_bcIJDQ	Intermediate_epidermis
i3_intact_S2_bcAADL	Tcells
i3_intact_S2_bcAAED	Intermediate_epidermis
i3_intact_S2_bcAAEY	SSCs
i3_intact_S2_bcAAFE	Intermediate_epidermis
i3_intact_S2_bcAAMF	SSCs
i3_intact_S2_bcAAMN	Intermediate_epidermis
i3_intact_S2_bcAAOX	Intermediate_epidermis
i3_intact_S2_bcAAPZ	Intermediate_epidermis
i3_intact_S2_bcAARR	Intermediate_epidermis
i3_intact_S2_bcAAUJ	Intermediate_epidermis
i3_intact_S2_bcAAWT	Intermediate_epidermis
i3_intact_S2_bcABAD	Tcells
i3_intact_S2_bcABFM	Intermediate_epidermis
i3_intact_S2_bcABJE	Intermediate_epidermis
i3_intact_S2_bcABLV	SSCs
i3_intact_S2_bcABMO	Tcells
i3_intact_S2_bcABTD	Intermediate_epidermis
i3_intact_S2_bcABUG	Intermediate_epidermis
i3_intact_S2_bcABVT	Intermediate_epidermis
i3_intact_S2_bcACCK	Intermediate_epidermis
i3_intact_S2_bcACEB	Erythrocyte
i3_intact_S2_bcACLF	Intermediate_epidermis
i3_intact_S2_bcACSX	Intermediate_epidermis
i3_intact_S2_bcACUJ	Intermediate_epidermis
i3_intact_S2_bcACWM	SSCs
i3_intact_S2_bcADAC	Proliferating_Epidermis
i3_intact_S2_bcADCO	BasalEpidermis
i3_intact_S2_bcADMC	Intermediate_epidermis
i3_intact_S2_bcADOH	Intermediate_epidermis
i3_intact_S2_bcADRU	SSCs
i3_intact_S2_bcADVR	Tcells
i3_intact_S2_bcAEAU	Intermediate_epidermis
i3_intact_S2_bcAECL	Intermediate_epidermis
i3_intact_S2_bcAEEA	Intermediate_epidermis
i3_intact_S2_bcAEIM	SSCs
i3_intact_S2_bcAEKR	Intermediate_epidermis
i3_intact_S2_bcAELP	Intermediate_epidermis
i3_intact_S2_bcAEMK	Intermediate_epidermis
i3_intact_S2_bcAENH	Intermediate_epidermis
i3_intact_S2_bcAEPY	SSCs
i3_intact_S2_bcAESC	Epidermal_Langerhans
i3_intact_S2_bcAEXI	Intermediate_epidermis
i3_intact_S2_bcAEYA	Ionocytes
i3_intact_S2_bcAFBC	SSCs
i3_intact_S2_bcAFCE	Intermediate_epidermis
i3_intact_S2_bcAFOM	Early_B
i3_intact_S2_bcAFRB	BasalEpidermis
i3_intact_S2_bcAFTE	Erythrocyte
i3_intact_S2_bcAFUH	Tcells
i3_intact_S2_bcAFXA	Intermediate_epidermis
i3_intact_S2_bcAFYK	Tcells
i3_intact_S2_bcAFZP	Ionocytes
i3_intact_S2_bcAGDZ	SSCs
i3_intact_S2_bcAGOQ	Early_B
i3_intact_S2_bcAGPO	Intermediate_epidermis
i3_intact_S2_bcAGUS	Proliferating_Epidermis
i3_intact_S2_bcAGVL	Proliferating_Epidermis
i3_intact_S2_bcAGWC	Tcells
i3_intact_S2_bcAGXE	Intermediate_epidermis
i3_intact_S2_bcAHDL	Intermediate_epidermis
i3_intact_S2_bcAHEP	Intermediate_epidermis
i3_intact_S2_bcAHII	Intermediate_epidermis
i3_intact_S2_bcAHLQ	Tcells
i3_intact_S2_bcAHLZ	Intermediate_epidermis
i3_intact_S2_bcAHNC	Intermediate_epidermis
i3_intact_S2_bcAHNM	SSCs
i3_intact_S2_bcAHOE	Intermediate_epidermis
i3_intact_S2_bcAHQY	Fibroblast
i3_intact_S2_bcAHSH	Intermediate_epidermis
i3_intact_S2_bcAHTY	Intermediate_epidermis
i3_intact_S2_bcAHUH	Intermediate_epidermis
i3_intact_S2_bcAHYS	Intermediate_epidermis
i3_intact_S2_bcAIGT	Intermediate_epidermis
i3_intact_S2_bcAIIW	Tcells
i3_intact_S2_bcAIJO	Intermediate_epidermis
i3_intact_S2_bcAIKB	Proliferating_Epidermis
i3_intact_S2_bcAILN	Intermediate_epidermis
i3_intact_S2_bcAILQ	SSCs
i3_intact_S2_bcAINS	SSCs
i3_intact_S2_bcAIQA	Myeloid
i3_intact_S2_bcAIXU	SSCs
i3_intact_S2_bcAIZW	Fibroblast
i3_intact_S2_bcAJFF	Intermediate_epidermis
i3_intact_S2_bcAJFY	Intermediate_epidermis
i3_intact_S2_bcAJIZ	Intermediate_epidermis
i3_intact_S2_bcAJNX	Intermediate_epidermis
i3_intact_S2_bcAJRK	Intermediate_epidermis
i3_intact_S2_bcAJTP	Intermediate_epidermis
i3_intact_S2_bcAJUR	SSCs
i3_intact_S2_bcAKAQ	Intermediate_epidermis
i3_intact_S2_bcAKBM	Intermediate_epidermis
i3_intact_S2_bcAKDU	Intermediate_epidermis
i3_intact_S2_bcAKGN	SSCs
i3_intact_S2_bcAKGY	SSCs
i3_intact_S2_bcAKKC	Tcells
i3_intact_S2_bcAKVI	Proliferating_Epidermis
i3_intact_S2_bcAKXE	Proliferating_Epidermis
i3_intact_S2_bcAKYI	BasalEpidermis
i3_intact_S2_bcALIK	Intermediate_epidermis
i3_intact_S2_bcALJD	Intermediate_epidermis
i3_intact_S2_bcALMK	Intermediate_epidermis
i3_intact_S2_bcALNC	SSCs
i3_intact_S2_bcALNM	Intermediate_epidermis
i3_intact_S2_bcALOA	Intermediate_epidermis
i3_intact_S2_bcALQS	SSCs
i3_intact_S2_bcALTV	Intermediate_epidermis
i3_intact_S2_bcALUR	Myeloid
i3_intact_S2_bcALXB	Tcells
i3_intact_S2_bcALXO	Intermediate_epidermis
i3_intact_S2_bcAMCS	Tcells
i3_intact_S2_bcAMHB	Intermediate_epidermis
i3_intact_S2_bcAMKO	Intermediate_epidermis
i3_intact_S2_bcAMKU	Tcells
i3_intact_S2_bcAMTN	BasalEpidermis
i3_intact_S2_bcAMUR	BasalEpidermis
i3_intact_S2_bcAMVE	Intermediate_epidermis
i3_intact_S2_bcAMYF	Intermediate_epidermis
i3_intact_S2_bcANEW	Intermediate_epidermis
i3_intact_S2_bcANGC	Intermediate_epidermis
i3_intact_S2_bcANGT	Intermediate_epidermis
i3_intact_S2_bcANQG	Intermediate_epidermis
i3_intact_S2_bcANQQ	Intermediate_epidermis
i3_intact_S2_bcANUQ	Intermediate_epidermis
i3_intact_S2_bcANWP	Intermediate_epidermis
i3_intact_S2_bcANYG	Proliferating_Epidermis
i3_intact_S2_bcANZK	Intermediate_epidermis
i3_intact_S2_bcANZM	Intermediate_epidermis
i3_intact_S2_bcAOEZ	Proliferating_Epidermis
i3_intact_S2_bcAOFL	Intermediate_epidermis
i3_intact_S2_bcAOGF	Fibroblast
i3_intact_S2_bcAOJI	Intermediate_epidermis
i3_intact_S2_bcAOLW	Intermediate_epidermis
i3_intact_S2_bcAOVN	Proliferating_Epidermis
i3_intact_S2_bcAOWB	Intermediate_epidermis
i3_intact_S2_bcAOWG	Intermediate_epidermis
i3_intact_S2_bcAPDP	Intermediate_epidermis
i3_intact_S2_bcAPFC	Intermediate_epidermis
i3_intact_S2_bcAPGX	Intermediate_epidermis
i3_intact_S2_bcAPJY	SSCs
i3_intact_S2_bcAPLK	Intermediate_epidermis
i3_intact_S2_bcAPLT	Intermediate_epidermis
i3_intact_S2_bcAPTB	BasalEpidermis
i3_intact_S2_bcAPTQ	Tcells
i3_intact_S2_bcAPUP	Intermediate_epidermis
i3_intact_S2_bcAPYQ	BasalEpidermis
i3_intact_S2_bcAQBE	SSCs
i3_intact_S2_bcAQID	Erythrocyte
i3_intact_S2_bcAQMU	Proliferating_Epidermis
i3_intact_S2_bcAQUN	Tcells
i3_intact_S2_bcAQWO	Intermediate_epidermis
i3_intact_S2_bcAQZP	Tcells
i3_intact_S2_bcARAV	Epidermal_Langerhans
i3_intact_S2_bcARDQ	Intermediate_epidermis
i3_intact_S2_bcARGU	Proliferating_Epidermis
i3_intact_S2_bcARNV	Intermediate_epidermis
i3_intact_S2_bcARPZ	Intermediate_epidermis
i3_intact_S2_bcARRL	Ionocytes
i3_intact_S2_bcARRX	Intermediate_epidermis
i3_intact_S2_bcARTI	Intermediate_epidermis
i3_intact_S2_bcARYT	Tcells
i3_intact_S2_bcARZE	Intermediate_epidermis
i3_intact_S2_bcASAZ	Intermediate_epidermis
i3_intact_S2_bcASCP	Proliferating_Epidermis
i3_intact_S2_bcASDQ	Tcells
i3_intact_S2_bcASGC	Intermediate_epidermis
i3_intact_S2_bcASGJ	Intermediate_epidermis
i3_intact_S2_bcASHJ	Intermediate_epidermis
i3_intact_S2_bcASJW	Intermediate_epidermis
i3_intact_S2_bcASMR	Intermediate_epidermis
i3_intact_S2_bcASNB	BasalEpidermis
i3_intact_S2_bcASPE	Epidermal_Langerhans
i3_intact_S2_bcASPN	BasalEpidermis
i3_intact_S2_bcASPY	Intermediate_epidermis
i3_intact_S2_bcASVK	Intermediate_epidermis
i3_intact_S2_bcASVS	Intermediate_epidermis
i3_intact_S2_bcASVT	Tcells
i3_intact_S2_bcASVV	Intermediate_epidermis
i3_intact_S2_bcASWW	Intermediate_epidermis
i3_intact_S2_bcATBT	Intermediate_epidermis
i3_intact_S2_bcATBV	Intermediate_epidermis
i3_intact_S2_bcATCX	Tcells
i3_intact_S2_bcATDO	Intermediate_epidermis
i3_intact_S2_bcATDU	Proliferating_Epidermis
i3_intact_S2_bcATDY	Intermediate_epidermis
i3_intact_S2_bcATEA	Intermediate_epidermis
i3_intact_S2_bcATET	Myeloid
i3_intact_S2_bcATHC	Fibroblast
i3_intact_S2_bcATHM	Myeloid
i3_intact_S2_bcATKD	Tcells
i3_intact_S2_bcATME	Intermediate_epidermis
i3_intact_S2_bcATPZ	Tcells
i3_intact_S2_bcATSP	Intermediate_epidermis
i3_intact_S2_bcATUF	Intermediate_epidermis
i3_intact_S2_bcAUBA	Intermediate_epidermis
i3_intact_S2_bcAUDJ	SSCs
i3_intact_S2_bcAUGM	Intermediate_epidermis
i3_intact_S2_bcAUHJ	Intermediate_epidermis
i3_intact_S2_bcAUHP	Tcells
i3_intact_S2_bcAUKJ	SSCs
i3_intact_S2_bcAULI	Intermediate_epidermis
i3_intact_S2_bcAUMO	Intermediate_epidermis
i3_intact_S2_bcAUNB	Intermediate_epidermis
i3_intact_S2_bcAUPH	Intermediate_epidermis
i3_intact_S2_bcAUPV	Intermediate_epidermis
i3_intact_S2_bcAUQA	SSCs
i3_intact_S2_bcAURL	Early_B
i3_intact_S2_bcAUTB	Intermediate_epidermis
i3_intact_S2_bcAUUE	Tcells
i3_intact_S2_bcAUXX	Intermediate_epidermis
i3_intact_S2_bcAUYZ	Proliferating_Epidermis
i3_intact_S2_bcAUZP	Intermediate_epidermis
i3_intact_S2_bcAVCB	SSCs
i3_intact_S2_bcAVDO	Intermediate_epidermis
i3_intact_S2_bcAVHC	Intermediate_epidermis
i3_intact_S2_bcAVHK	Intermediate_epidermis
i3_intact_S2_bcAVNO	Intermediate_epidermis
i3_intact_S2_bcAVQR	Intermediate_epidermis
i3_intact_S2_bcAVYB	SSCs
i3_intact_S2_bcAVYC	Intermediate_epidermis
i3_intact_S2_bcAVYP	Intermediate_epidermis
i3_intact_S2_bcAVZE	Intermediate_epidermis
i3_intact_S2_bcAWGZ	Intermediate_epidermis
i3_intact_S2_bcAWNM	Intermediate_epidermis
i3_intact_S2_bcAWQF	Intermediate_epidermis
i3_intact_S2_bcAWVD	SSCs
i3_intact_S2_bcAWVH	Tcells
i3_intact_S2_bcAWVQ	Intermediate_epidermis
i3_intact_S2_bcAWWW	SSCs
i3_intact_S2_bcAXBJ	Erythrocyte
i3_intact_S2_bcAXCS	Intermediate_epidermis
i3_intact_S2_bcAXES	Intermediate_epidermis
i3_intact_S2_bcAXHZ	Intermediate_epidermis
i3_intact_S2_bcAXJP	SSCs
i3_intact_S2_bcAXLQ	Intermediate_epidermis
i3_intact_S2_bcAXNB	SSCs
i3_intact_S2_bcAXNQ	Intermediate_epidermis
i3_intact_S2_bcAXRW	Intermediate_epidermis
i3_intact_S2_bcAXUH	Intermediate_epidermis
i3_intact_S2_bcAXWK	SSCs
i3_intact_S2_bcAXYV	Proliferating_Epidermis
i3_intact_S2_bcAYDI	Intermediate_epidermis
i3_intact_S2_bcAYEI	Intermediate_epidermis
i3_intact_S2_bcAYEM	Intermediate_epidermis
i3_intact_S2_bcAYER	Intermediate_epidermis
i3_intact_S2_bcAYGG	Intermediate_epidermis
i3_intact_S2_bcAYGP	Intermediate_epidermis
i3_intact_S2_bcAYNB	Intermediate_epidermis
i3_intact_S2_bcAYOF	Intermediate_epidermis
i3_intact_S2_bcAYOM	BasalEpidermis
i3_intact_S2_bcAYSD	Intermediate_epidermis
i3_intact_S2_bcAYYB	Intermediate_epidermis
i3_intact_S2_bcAZCP	Intermediate_epidermis
i3_intact_S2_bcAZKF	Intermediate_epidermis
i3_intact_S2_bcAZKI	Intermediate_epidermis
i3_intact_S2_bcAZQS	Intermediate_epidermis
i3_intact_S2_bcAZSK	Intermediate_epidermis
i3_intact_S2_bcAZWL	BasalEpidermis
i3_intact_S2_bcAZYM	Proliferating_Epidermis
i3_intact_S2_bcAZZZ	Intermediate_epidermis
i3_intact_S2_bcBAET	Intermediate_epidermis
i3_intact_S2_bcBAGW	Intermediate_epidermis
i3_intact_S2_bcBAKA	Intermediate_epidermis
i3_intact_S2_bcBANS	SSCs
i3_intact_S2_bcBARZ	SSCs
i3_intact_S2_bcBATC	Intermediate_epidermis
i3_intact_S2_bcBATN	Intermediate_epidermis
i3_intact_S2_bcBAZI	Intermediate_epidermis
i3_intact_S2_bcBBDP	Intermediate_epidermis
i3_intact_S2_bcBBFX	Intermediate_epidermis
i3_intact_S2_bcBBGQ	Intermediate_epidermis
i3_intact_S2_bcBBJA	SSCs
i3_intact_S2_bcBBJL	Intermediate_epidermis
i3_intact_S2_bcBBJT	Tcells
i3_intact_S2_bcBBOH	BasalEpidermis
i3_intact_S2_bcBBOX	Intermediate_epidermis
i3_intact_S2_bcBBPF	SSCs
i3_intact_S2_bcBBQB	Intermediate_epidermis
i3_intact_S2_bcBBTZ	Proliferating_Epidermis
i3_intact_S2_bcBBUA	Intermediate_epidermis
i3_intact_S2_bcBBXS	Intermediate_epidermis
i3_intact_S2_bcBCAR	Intermediate_epidermis
i3_intact_S2_bcBCDL	Intermediate_epidermis
i3_intact_S2_bcBCEP	Intermediate_epidermis
i3_intact_S2_bcBCFR	Intermediate_epidermis
i3_intact_S2_bcBCHE	Fibroblast
i3_intact_S2_bcBCLM	Tcells
i3_intact_S2_bcBCMF	BasalEpidermis
i3_intact_S2_bcBCMY	Intermediate_epidermis
i3_intact_S2_bcBCSJ	Intermediate_epidermis
i3_intact_S2_bcBCVE	Proliferating_Epidermis
i3_intact_S2_bcBDAQ	Intermediate_epidermis
i3_intact_S2_bcBDBN	Intermediate_epidermis
i3_intact_S2_bcBDKE	Intermediate_epidermis
i3_intact_S2_bcBDMQ	Intermediate_epidermis
i3_intact_S2_bcBDOL	Early_B
i3_intact_S2_bcBDRT	Intermediate_epidermis
i3_intact_S2_bcBDWG	Myeloid
i3_intact_S2_bcBEBZ	SSCs
i3_intact_S2_bcBECW	Intermediate_epidermis
i3_intact_S2_bcBEDX	Intermediate_epidermis
i3_intact_S2_bcBEGA	Intermediate_epidermis
i3_intact_S2_bcBEGK	Intermediate_epidermis
i3_intact_S2_bcBEKK	Tcells
i3_intact_S2_bcBENH	Tcells
i3_intact_S2_bcBEPH	Intermediate_epidermis
i3_intact_S2_bcBESG	Erythrocyte
i3_intact_S2_bcBEYI	BasalEpidermis
i3_intact_S2_bcBEYM	BasalEpidermis
i3_intact_S2_bcBFHB	Intermediate_epidermis
i3_intact_S2_bcBFOG	Intermediate_epidermis
i3_intact_S2_bcBFRC	SSCs
i3_intact_S2_bcBFSB	Intermediate_epidermis
i3_intact_S2_bcBFYB	SSCs
i3_intact_S2_bcBFZI	SSCs
i3_intact_S2_bcBGCL	Intermediate_epidermis
i3_intact_S2_bcBGIP	Intermediate_epidermis
i3_intact_S2_bcBGLS	BasalEpidermis
i3_intact_S2_bcBGNQ	Intermediate_epidermis
i3_intact_S2_bcBGNX	Intermediate_epidermis
i3_intact_S2_bcBGPQ	Proliferating_Epidermis
i3_intact_S2_bcBGSI	SSCs
i3_intact_S2_bcBGWT	Intermediate_epidermis
i3_intact_S2_bcBGXC	Tcells
i3_intact_S2_bcBHBU	SSCs
i3_intact_S2_bcBHFZ	Intermediate_epidermis
i3_intact_S2_bcBHIZ	Erythrocyte
i3_intact_S2_bcBHSI	Intermediate_epidermis
i3_intact_S2_bcBHWS	Proliferating_Epidermis
i3_intact_S2_bcBHWY	Intermediate_epidermis
i3_intact_S2_bcBIDG	Intermediate_epidermis
i3_intact_S2_bcBILG	Intermediate_epidermis
i3_intact_S2_bcBILS	Tcells
i3_intact_S2_bcBIMZ	Intermediate_epidermis
i3_intact_S2_bcBINB	Intermediate_epidermis
i3_intact_S2_bcBINQ	Intermediate_epidermis
i3_intact_S2_bcBITQ	Tcells
i3_intact_S2_bcBIUB	Intermediate_epidermis
i3_intact_S2_bcBIUC	Intermediate_epidermis
i3_intact_S2_bcBIUO	Intermediate_epidermis
i3_intact_S2_bcBIUR	BasalEpidermis
i3_intact_S2_bcBIXB	Intermediate_epidermis
i3_intact_S2_bcBJAH	Intermediate_epidermis
i3_intact_S2_bcBJBP	Intermediate_epidermis
i3_intact_S2_bcBJGM	Intermediate_epidermis
i3_intact_S2_bcBJJQ	Intermediate_epidermis
i3_intact_S2_bcBJKS	Myeloid
i3_intact_S2_bcBJKV	Intermediate_epidermis
i3_intact_S2_bcBJMN	BasalEpidermis
i3_intact_S2_bcBJNB	Intermediate_epidermis
i3_intact_S2_bcBJNR	Early_B
i3_intact_S2_bcBJQF	Epidermal_Langerhans
i3_intact_S2_bcBJXA	Myeloid
i3_intact_S2_bcBJXI	Intermediate_epidermis
i3_intact_S2_bcBKFL	Intermediate_epidermis
i3_intact_S2_bcBKGM	SSCs
i3_intact_S2_bcBKHP	Intermediate_epidermis
i3_intact_S2_bcBKMT	Tcells
i3_intact_S2_bcBKPH	Intermediate_epidermis
i3_intact_S2_bcBKSZ	Intermediate_epidermis
i3_intact_S2_bcBKTS	Intermediate_epidermis
i3_intact_S2_bcBKZS	Intermediate_epidermis
i3_intact_S2_bcBLAY	Intermediate_epidermis
i3_intact_S2_bcBLDB	Tcells
i3_intact_S2_bcBLDW	Intermediate_epidermis
i3_intact_S2_bcBLFP	Erythrocyte
i3_intact_S2_bcBLFQ	Intermediate_epidermis
i3_intact_S2_bcBLJP	Intermediate_epidermis
i3_intact_S2_bcBLKD	Intermediate_epidermis
i3_intact_S2_bcBLKT	Early_B
i3_intact_S2_bcBLMI	Intermediate_epidermis
i3_intact_S2_bcBLPN	Proliferating_Epidermis
i3_intact_S2_bcBLRF	Tcells
i3_intact_S2_bcBLTC	Intermediate_epidermis
i3_intact_S2_bcBLUD	Intermediate_epidermis
i3_intact_S2_bcBLXX	Proliferating_Epidermis
i3_intact_S2_bcBMBW	SSCs
i3_intact_S2_bcBMLM	Proliferating_Epidermis
i3_intact_S2_bcBMVD	Myeloid
i3_intact_S2_bcBNAA	Intermediate_epidermis
i3_intact_S2_bcBNHK	Intermediate_epidermis
i3_intact_S2_bcBNIM	BasalEpidermis
i3_intact_S2_bcBNOF	Intermediate_epidermis
i3_intact_S2_bcBNSM	Intermediate_epidermis
i3_intact_S2_bcBNYG	Intermediate_epidermis
i3_intact_S2_bcBOGR	Intermediate_epidermis
i3_intact_S2_bcBOLT	Myeloid
i3_intact_S2_bcBORK	Tcells
i3_intact_S2_bcBOSZ	Proliferating_Epidermis
i3_intact_S2_bcBOTD	Proliferating_Epidermis
i3_intact_S2_bcBOYI	Intermediate_epidermis
i3_intact_S2_bcBOZA	Intermediate_epidermis
i3_intact_S2_bcBOZI	Intermediate_epidermis
i3_intact_S2_bcBPBN	Intermediate_epidermis
i3_intact_S2_bcBPDI	Epidermal_Langerhans
i3_intact_S2_bcBPDT	Intermediate_epidermis
i3_intact_S2_bcBPGQ	BasalEpidermis
i3_intact_S2_bcBPSH	Intermediate_epidermis
i3_intact_S2_bcBPTI	Intermediate_epidermis
i3_intact_S2_bcBPUM	Intermediate_epidermis
i3_intact_S2_bcBPVF	Tcells
i3_intact_S2_bcBPWF	SSCs
i3_intact_S2_bcBPXG	Epidermal_Langerhans
i3_intact_S2_bcBQGY	Tcells
i3_intact_S2_bcBQIV	Intermediate_epidermis
i3_intact_S2_bcBQJX	Tcells
i3_intact_S2_bcBQKE	Early_B
i3_intact_S2_bcBQLI	Intermediate_epidermis
i3_intact_S2_bcBQLW	SSCs
i3_intact_S2_bcBQNJ	Intermediate_epidermis
i3_intact_S2_bcBQQG	Intermediate_epidermis
i3_intact_S2_bcBQRB	Intermediate_epidermis
i3_intact_S2_bcBQYC	Intermediate_epidermis
i3_intact_S2_bcBRAP	Intermediate_epidermis
i3_intact_S2_bcBRAW	Myeloid
i3_intact_S2_bcBRCT	Proliferating_Epidermis
i3_intact_S2_bcBRMJ	Erythrocyte
i3_intact_S2_bcBROE	Intermediate_epidermis
i3_intact_S2_bcBRPO	Intermediate_epidermis
i3_intact_S2_bcBRWS	Intermediate_epidermis
i3_intact_S2_bcBRXH	SSCs
i3_intact_S2_bcBRXJ	Intermediate_epidermis
i3_intact_S2_bcBSAY	Intermediate_epidermis
i3_intact_S2_bcBSBV	Intermediate_epidermis
i3_intact_S2_bcBSDQ	BasalEpidermis
i3_intact_S2_bcBSFT	Tcells
i3_intact_S2_bcBSKX	Intermediate_epidermis
i3_intact_S2_bcBSSZ	Intermediate_epidermis
i3_intact_S2_bcBSXB	Proliferating_Epidermis
i3_intact_S2_bcBTDF	Intermediate_epidermis
i3_intact_S2_bcBTFJ	Intermediate_epidermis
i3_intact_S2_bcBTGU	Tcells
i3_intact_S2_bcBTHH	Intermediate_epidermis
i3_intact_S2_bcBTKN	Intermediate_epidermis
i3_intact_S2_bcBTLF	Intermediate_epidermis
i3_intact_S2_bcBTVG	Proliferating_Epidermis
i3_intact_S2_bcBTWG	Proliferating_Epidermis
i3_intact_S2_bcBTZS	Intermediate_epidermis
i3_intact_S2_bcBUBL	SSCs
i3_intact_S2_bcBUCQ	Intermediate_epidermis
i3_intact_S2_bcBUER	Myeloid
i3_intact_S2_bcBUFQ	Myeloid
i3_intact_S2_bcBUGZ	Intermediate_epidermis
i3_intact_S2_bcBUNP	Intermediate_epidermis
i3_intact_S2_bcBUOF	Intermediate_epidermis
i3_intact_S2_bcBUPF	Intermediate_epidermis
i3_intact_S2_bcBUPW	Intermediate_epidermis
i3_intact_S2_bcBUTZ	Tcells
i3_intact_S2_bcBUXH	Proliferating_Epidermis
i3_intact_S2_bcBUYC	Intermediate_epidermis
i3_intact_S2_bcBUYE	Myeloid
i3_intact_S2_bcBUZE	Proliferating_Epidermis
i3_intact_S2_bcBUZF	Intermediate_epidermis
i3_intact_S2_bcBVLK	Intermediate_epidermis
i3_intact_S2_bcBVNT	Intermediate_epidermis
i3_intact_S2_bcBVQO	Intermediate_epidermis
i3_intact_S2_bcBVWO	Proliferating_Epidermis
i3_intact_S2_bcBWAP	BasalEpidermis
i3_intact_S2_bcBWEI	Intermediate_epidermis
i3_intact_S2_bcBWLQ	Tcells
i3_intact_S2_bcBWPI	Intermediate_epidermis
i3_intact_S2_bcBWTM	Intermediate_epidermis
i3_intact_S2_bcBWTU	Epidermal_Langerhans
i3_intact_S2_bcBWWY	BasalEpidermis
i3_intact_S2_bcBWXE	Intermediate_epidermis
i3_intact_S2_bcBWXM	Intermediate_epidermis
i3_intact_S2_bcBWYC	Epidermal_Langerhans
i3_intact_S2_bcBWZK	Intermediate_epidermis
i3_intact_S2_bcBXEM	Tcells
i3_intact_S2_bcBXJM	Intermediate_epidermis
i3_intact_S2_bcBXMI	SSCs
i3_intact_S2_bcBXNS	Intermediate_epidermis
i3_intact_S2_bcBXOJ	Early_B
i3_intact_S2_bcBXPG	Intermediate_epidermis
i3_intact_S2_bcBXPU	Epidermal_Langerhans
i3_intact_S2_bcBXQV	Tcells
i3_intact_S2_bcBXVD	Proliferating_Epidermis
i3_intact_S2_bcBXWB	Epidermal_Langerhans
i3_intact_S2_bcBYBU	Intermediate_epidermis
i3_intact_S2_bcBYHP	Intermediate_epidermis
i3_intact_S2_bcBYHZ	SSCs
i3_intact_S2_bcBYIA	BasalEpidermis
i3_intact_S2_bcBYIO	BasalEpidermis
i3_intact_S2_bcBYJH	Intermediate_epidermis
i3_intact_S2_bcBYKH	Intermediate_epidermis
i3_intact_S2_bcBYKZ	Intermediate_epidermis
i3_intact_S2_bcBYOD	Intermediate_epidermis
i3_intact_S2_bcBYOP	Myeloid
i3_intact_S2_bcBYUM	Intermediate_epidermis
i3_intact_S2_bcBYWC	Intermediate_epidermis
i3_intact_S2_bcBYWI	SSCs
i3_intact_S2_bcBYXJ	Intermediate_epidermis
i3_intact_S2_bcBYZB	Intermediate_epidermis
i3_intact_S2_bcBZFL	BasalEpidermis
i3_intact_S2_bcBZIM	Intermediate_epidermis
i3_intact_S2_bcBZJR	Tcells
i3_intact_S2_bcBZSU	Intermediate_epidermis
i3_intact_S2_bcBZXI	Intermediate_epidermis
i3_intact_S2_bcCACQ	SSCs
i3_intact_S2_bcCADC	Erythrocyte
i3_intact_S2_bcCAFV	Intermediate_epidermis
i3_intact_S2_bcCAGH	Intermediate_epidermis
i3_intact_S2_bcCAJW	Intermediate_epidermis
i3_intact_S2_bcCATT	Intermediate_epidermis
i3_intact_S2_bcCAWF	Proliferating_Epidermis
i3_intact_S2_bcCAWI	Intermediate_epidermis
i3_intact_S2_bcCBBE	Intermediate_epidermis
i3_intact_S2_bcCBEI	Intermediate_epidermis
i3_intact_S2_bcCBHM	SSCs
i3_intact_S2_bcCBIJ	Intermediate_epidermis
i3_intact_S2_bcCBKT	Intermediate_epidermis
i3_intact_S2_bcCBLC	Intermediate_epidermis
i3_intact_S2_bcCBLR	Intermediate_epidermis
i3_intact_S2_bcCBPG	Intermediate_epidermis
i3_intact_S2_bcCBSL	Intermediate_epidermis
i3_intact_S2_bcCBWC	Myeloid
i3_intact_S2_bcCBWZ	Intermediate_epidermis
i3_intact_S2_bcCBXJ	Intermediate_epidermis
i3_intact_S2_bcCBXP	Intermediate_epidermis
i3_intact_S2_bcCCBN	Intermediate_epidermis
i3_intact_S2_bcCCDX	SSCs
i3_intact_S2_bcCCGQ	Intermediate_epidermis
i3_intact_S2_bcCCLD	Intermediate_epidermis
i3_intact_S2_bcCCLV	Myeloid
i3_intact_S2_bcCCMC	Intermediate_epidermis
i3_intact_S2_bcCCPO	Intermediate_epidermis
i3_intact_S2_bcCCQJ	Intermediate_epidermis
i3_intact_S2_bcCCUA	Intermediate_epidermis
i3_intact_S2_bcCCUE	Intermediate_epidermis
i3_intact_S2_bcCCVA	Intermediate_epidermis
i3_intact_S2_bcCCVF	Fibroblast
i3_intact_S2_bcCCWD	Intermediate_epidermis
i3_intact_S2_bcCCZB	Intermediate_epidermis
i3_intact_S2_bcCDBN	SSCs
i3_intact_S2_bcCDFN	Intermediate_epidermis
i3_intact_S2_bcCDJK	Intermediate_epidermis
i3_intact_S2_bcCDKI	Intermediate_epidermis
i3_intact_S2_bcCDMZ	Intermediate_epidermis
i3_intact_S2_bcCDQT	Intermediate_epidermis
i3_intact_S2_bcCDRO	Myeloid
i3_intact_S2_bcCDZM	Intermediate_epidermis
i3_intact_S2_bcCEBC	Intermediate_epidermis
i3_intact_S2_bcCECG	Intermediate_epidermis
i3_intact_S2_bcCEER	Tcells
i3_intact_S2_bcCEGV	Intermediate_epidermis
i3_intact_S2_bcCEJB	Intermediate_epidermis
i3_intact_S2_bcCEJI	Intermediate_epidermis
i3_intact_S2_bcCEKQ	Intermediate_epidermis
i3_intact_S2_bcCENH	Myeloid
i3_intact_S2_bcCENU	Intermediate_epidermis
i3_intact_S2_bcCEQB	Intermediate_epidermis
i3_intact_S2_bcCERA	SSCs
i3_intact_S2_bcCEVO	Intermediate_epidermis
i3_intact_S2_bcCEXQ	Epidermal_Langerhans
i3_intact_S2_bcCFBF	Proliferating_Epidermis
i3_intact_S2_bcCFHE	Intermediate_epidermis
i3_intact_S2_bcCFJL	Intermediate_epidermis
i3_intact_S2_bcCFKM	Tcells
i3_intact_S2_bcCFKQ	Intermediate_epidermis
i3_intact_S2_bcCFLH	Intermediate_epidermis
i3_intact_S2_bcCFMO	Intermediate_epidermis
i3_intact_S2_bcCFNF	Intermediate_epidermis
i3_intact_S2_bcCFNT	Intermediate_epidermis
i3_intact_S2_bcCFZO	Intermediate_epidermis
i3_intact_S2_bcCFZZ	Intermediate_epidermis
i3_intact_S2_bcCGCG	Tcells
i3_intact_S2_bcCGDK	Intermediate_epidermis
i3_intact_S2_bcCGEM	Epidermal_Langerhans
i3_intact_S2_bcCGFC	Intermediate_epidermis
i3_intact_S2_bcCGKR	Intermediate_epidermis
i3_intact_S2_bcCGLP	Intermediate_epidermis
i3_intact_S2_bcCGMP	Tcells
i3_intact_S2_bcCGPT	Proliferating_Epidermis
i3_intact_S2_bcCGQM	Erythrocyte
i3_intact_S2_bcCGRG	Intermediate_epidermis
i3_intact_S2_bcCGVT	Myeloid
i3_intact_S2_bcCGXP	Tcells
i3_intact_S2_bcCHCM	Intermediate_epidermis
i3_intact_S2_bcCHDO	Intermediate_epidermis
i3_intact_S2_bcCHED	Intermediate_epidermis
i3_intact_S2_bcCHEK	Intermediate_epidermis
i3_intact_S2_bcCHGO	Intermediate_epidermis
i3_intact_S2_bcCHIS	BasalEpidermis
i3_intact_S2_bcCHIY	Tcells
i3_intact_S2_bcCHJQ	Proliferating_Epidermis
i3_intact_S2_bcCHKY	Intermediate_epidermis
i3_intact_S2_bcCHOP	Erythrocyte
i3_intact_S2_bcCHSB	Intermediate_epidermis
i3_intact_S2_bcCHSG	Intermediate_epidermis
i3_intact_S2_bcCHYS	Intermediate_epidermis
i3_intact_S2_bcCIAD	Intermediate_epidermis
i3_intact_S2_bcCIDP	Intermediate_epidermis
i3_intact_S2_bcCIHY	SSCs
i3_intact_S2_bcCIHZ	Intermediate_epidermis
i3_intact_S2_bcCIKK	Intermediate_epidermis
i3_intact_S2_bcCITU	Intermediate_epidermis
i3_intact_S2_bcCIUY	Myeloid
i3_intact_S2_bcCIWG	SSCs
i3_intact_S2_bcCIWJ	Ionocytes
i3_intact_S2_bcCIWN	Epidermal_Langerhans
i3_intact_S2_bcCIXM	Intermediate_epidermis
i3_intact_S2_bcCIYO	Intermediate_epidermis
i3_intact_S2_bcCJCD	SSCs
i3_intact_S2_bcCJCM	Proliferating_Epidermis
i3_intact_S2_bcCJDI	Intermediate_epidermis
i3_intact_S2_bcCJFY	BasalEpidermis
i3_intact_S2_bcCJGZ	SSCs
i3_intact_S2_bcCJHB	Epidermal_Langerhans
i3_intact_S2_bcCJHS	Intermediate_epidermis
i3_intact_S2_bcCJJK	Fibroblast
i3_intact_S2_bcCJJP	Intermediate_epidermis
i3_intact_S2_bcCJOG	Intermediate_epidermis
i3_intact_S2_bcCJQL	BasalEpidermis
i3_intact_S2_bcCJRC	Intermediate_epidermis
i3_intact_S2_bcCJUZ	Intermediate_epidermis
i3_intact_S2_bcCJVP	Epidermal_Langerhans
i3_intact_S2_bcCJYA	Intermediate_epidermis
i3_intact_S2_bcCKAV	Intermediate_epidermis
i3_intact_S2_bcCKBU	Proliferating_Epidermis
i3_intact_S2_bcCKCQ	Intermediate_epidermis
i3_intact_S2_bcCKFT	Intermediate_epidermis
i3_intact_S2_bcCKGK	Intermediate_epidermis
i3_intact_S2_bcCKHF	Intermediate_epidermis
i3_intact_S2_bcCKHK	SSCs
i3_intact_S2_bcCKPB	Proliferating_Epidermis
i3_intact_S2_bcCKQI	Proliferating_Epidermis
i3_intact_S2_bcCKRQ	Intermediate_epidermis
i3_intact_S2_bcCKVD	Intermediate_epidermis
i3_intact_S2_bcCKVF	SSCs
i3_intact_S2_bcCKVR	Intermediate_epidermis
i3_intact_S2_bcCKXA	SSCs
i3_intact_S2_bcCLKJ	Fibroblast
i3_intact_S2_bcCLMG	BasalEpidermis
i3_intact_S2_bcCLMJ	SSCs
i3_intact_S2_bcCLOE	SSCs
i3_intact_S2_bcCLQG	Intermediate_epidermis
i3_intact_S2_bcCLSL	BasalEpidermis
i3_intact_S2_bcCMAQ	Intermediate_epidermis
i3_intact_S2_bcCMMN	Intermediate_epidermis
i3_intact_S2_bcCMNF	Proliferating_Epidermis
i3_intact_S2_bcCMUS	Tcells
i3_intact_S2_bcCMVI	Intermediate_epidermis
i3_intact_S2_bcCMZR	Intermediate_epidermis
i3_intact_S2_bcCNBS	SSCs
i3_intact_S2_bcCNCF	Tcells
i3_intact_S2_bcCNCP	Epidermal_Langerhans
i3_intact_S2_bcCNDU	Intermediate_epidermis
i3_intact_S2_bcCNEW	Tcells
i3_intact_S2_bcCNJP	SSCs
i3_intact_S2_bcCNKO	Myeloid
i3_intact_S2_bcCNMZ	Ionocytes
i3_intact_S2_bcCNQT	Intermediate_epidermis
i3_intact_S2_bcCNTG	Tcells
i3_intact_S2_bcCNUI	Intermediate_epidermis
i3_intact_S2_bcCNVD	BasalEpidermis
i3_intact_S2_bcCNWS	Intermediate_epidermis
i3_intact_S2_bcCNXZ	Intermediate_epidermis
i3_intact_S2_bcCOCG	Intermediate_epidermis
i3_intact_S2_bcCODB	SSCs
i3_intact_S2_bcCOEP	Intermediate_epidermis
i3_intact_S2_bcCOFB	Intermediate_epidermis
i3_intact_S2_bcCOGC	Tcells
i3_intact_S2_bcCOGR	Intermediate_epidermis
i3_intact_S2_bcCOJM	Tcells
i3_intact_S2_bcCOMQ	Proliferating_Epidermis
i3_intact_S2_bcCOPJ	Intermediate_epidermis
i3_intact_S2_bcCOSI	Tcells
i3_intact_S2_bcCOVD	Intermediate_epidermis
i3_intact_S2_bcCPBH	Intermediate_epidermis
i3_intact_S2_bcCPDU	Intermediate_epidermis
i3_intact_S2_bcCPGQ	Intermediate_epidermis
i3_intact_S2_bcCPGW	SSCs
i3_intact_S2_bcCPIG	Intermediate_epidermis
i3_intact_S2_bcCPJZ	SSCs
i3_intact_S2_bcCPKW	Intermediate_epidermis
i3_intact_S2_bcCPLQ	Intermediate_epidermis
i3_intact_S2_bcCPPT	SSCs
i3_intact_S2_bcCPQJ	Intermediate_epidermis
i3_intact_S2_bcCPUO	Intermediate_epidermis
i3_intact_S2_bcCPXF	Intermediate_epidermis
i3_intact_S2_bcCPXQ	Fibroblast
i3_intact_S2_bcCPXW	Proliferating_Epidermis
i3_intact_S2_bcCPZI	Intermediate_epidermis
i3_intact_S2_bcCPZT	Intermediate_epidermis
i3_intact_S2_bcCQEO	BasalEpidermis
i3_intact_S2_bcCQHO	Intermediate_epidermis
i3_intact_S2_bcCQIE	Proliferating_Epidermis
i3_intact_S2_bcCQJS	Tcells
i3_intact_S2_bcCQJV	Tcells
i3_intact_S2_bcCQTT	BasalEpidermis
i3_intact_S2_bcCQUK	SSCs
i3_intact_S2_bcCQUN	Intermediate_epidermis
i3_intact_S2_bcCQUT	Intermediate_epidermis
i3_intact_S2_bcCQWV	Proliferating_Epidermis
i3_intact_S2_bcCRAR	Intermediate_epidermis
i3_intact_S2_bcCRAV	Intermediate_epidermis
i3_intact_S2_bcCRBX	Intermediate_epidermis
i3_intact_S2_bcCRCQ	Tcells
i3_intact_S2_bcCREX	Intermediate_epidermis
i3_intact_S2_bcCRGV	BasalEpidermis
i3_intact_S2_bcCRGY	Intermediate_epidermis
i3_intact_S2_bcCRHU	Proliferating_Epidermis
i3_intact_S2_bcCRIT	Intermediate_epidermis
i3_intact_S2_bcCRJP	Intermediate_epidermis
i3_intact_S2_bcCRRJ	Intermediate_epidermis
i3_intact_S2_bcCRRM	SSCs
i3_intact_S2_bcCRRN	Intermediate_epidermis
i3_intact_S2_bcCRRY	Tcells
i3_intact_S2_bcCRUP	Intermediate_epidermis
i3_intact_S2_bcCRXD	Proliferating_Epidermis
i3_intact_S2_bcCRYI	Myeloid
i3_intact_S2_bcCRYK	Intermediate_epidermis
i3_intact_S2_bcCRZL	Intermediate_epidermis
i3_intact_S2_bcCSDZ	Intermediate_epidermis
i3_intact_S2_bcCSFA	Intermediate_epidermis
i3_intact_S2_bcCSFC	Proliferating_Epidermis
i3_intact_S2_bcCSFL	Intermediate_epidermis
i3_intact_S2_bcCSFV	SSCs
i3_intact_S2_bcCSGY	Intermediate_epidermis
i3_intact_S2_bcCSHB	Intermediate_epidermis
i3_intact_S2_bcCSHK	Intermediate_epidermis
i3_intact_S2_bcCSMT	Intermediate_epidermis
i3_intact_S2_bcCSSO	Intermediate_epidermis
i3_intact_S2_bcCSSS	Intermediate_epidermis
i3_intact_S2_bcCSTR	Intermediate_epidermis
i3_intact_S2_bcCSVF	Intermediate_epidermis
i3_intact_S2_bcCSVW	Proliferating_Epidermis
i3_intact_S2_bcCSVZ	Proliferating_Epidermis
i3_intact_S2_bcCTAO	Intermediate_epidermis
i3_intact_S2_bcCTBZ	Intermediate_epidermis
i3_intact_S2_bcCTDT	Intermediate_epidermis
i3_intact_S2_bcCTDV	Intermediate_epidermis
i3_intact_S2_bcCTNN	Intermediate_epidermis
i3_intact_S2_bcCTNS	Myeloid
i3_intact_S2_bcCTQD	Intermediate_epidermis
i3_intact_S2_bcCTQZ	Myeloid
i3_intact_S2_bcCTSW	Intermediate_epidermis
i3_intact_S2_bcCTTM	Intermediate_epidermis
i3_intact_S2_bcCTVD	Intermediate_epidermis
i3_intact_S2_bcCTYE	Tcells
i3_intact_S2_bcCTYS	Intermediate_epidermis
i3_intact_S2_bcCUDB	Intermediate_epidermis
i3_intact_S2_bcCUMF	Intermediate_epidermis
i3_intact_S2_bcCUMT	Tcells
i3_intact_S2_bcCUNS	SSCs
i3_intact_S2_bcCUUX	Proliferating_Epidermis
i3_intact_S2_bcCUWF	Intermediate_epidermis
i3_intact_S2_bcCVBX	Tcells
i3_intact_S2_bcCVEE	Intermediate_epidermis
i3_intact_S2_bcCVEG	Intermediate_epidermis
i3_intact_S2_bcCVGD	Intermediate_epidermis
i3_intact_S2_bcCVIX	Intermediate_epidermis
i3_intact_S2_bcCVJK	BasalEpidermis
i3_intact_S2_bcCVJV	Intermediate_epidermis
i3_intact_S2_bcCVNW	Intermediate_epidermis
i3_intact_S2_bcCVOI	BasalEpidermis
i3_intact_S2_bcCVPD	Intermediate_epidermis
i3_intact_S2_bcCVQR	Tcells
i3_intact_S2_bcCVRQ	Tcells
i3_intact_S2_bcCVWW	Myeloid
i3_intact_S2_bcCVXM	Proliferating_Epidermis
i3_intact_S2_bcCVYQ	Intermediate_epidermis
i3_intact_S2_bcCVZA	Intermediate_epidermis
i3_intact_S2_bcCVZL	SSCs
i3_intact_S2_bcCWEB	Intermediate_epidermis
i3_intact_S2_bcCWEG	Fibroblast
i3_intact_S2_bcCWEH	Intermediate_epidermis
i3_intact_S2_bcCWFB	Intermediate_epidermis
i3_intact_S2_bcCWIY	Tcells
i3_intact_S2_bcCWJB	Intermediate_epidermis
i3_intact_S2_bcCWJH	BasalEpidermis
i3_intact_S2_bcCWLL	Intermediate_epidermis
i3_intact_S2_bcCWLM	Intermediate_epidermis
i3_intact_S2_bcCWMX	Intermediate_epidermis
i3_intact_S2_bcCWNR	SSCs
i3_intact_S2_bcCWOM	Myeloid
i3_intact_S2_bcCWOX	Intermediate_epidermis
i3_intact_S2_bcCWRR	Proliferating_Epidermis
i3_intact_S2_bcCWRU	Intermediate_epidermis
i3_intact_S2_bcCWTQ	Epidermal_Langerhans
i3_intact_S2_bcCWVV	Intermediate_epidermis
i3_intact_S2_bcCWXV	Intermediate_epidermis
i3_intact_S2_bcCWYB	Myeloid
i3_intact_S2_bcCXBM	Tcells
i3_intact_S2_bcCXCP	Intermediate_epidermis
i3_intact_S2_bcCXCX	Myeloid
i3_intact_S2_bcCXFY	Proliferating_Epidermis
i3_intact_S2_bcCXHY	Proliferating_Epidermis
i3_intact_S2_bcCXJY	Intermediate_epidermis
i3_intact_S2_bcCXKP	Intermediate_epidermis
i3_intact_S2_bcCXOV	Intermediate_epidermis
i3_intact_S2_bcCXPX	Tcells
i3_intact_S2_bcCXRI	Intermediate_epidermis
i3_intact_S2_bcCXRJ	Intermediate_epidermis
i3_intact_S2_bcCXRZ	Intermediate_epidermis
i3_intact_S2_bcCXTJ	Intermediate_epidermis
i3_intact_S2_bcCXXI	Tcells
i3_intact_S2_bcCXYJ	Proliferating_Epidermis
i3_intact_S2_bcCYBM	SSCs
i3_intact_S2_bcCYDN	Intermediate_epidermis
i3_intact_S2_bcCYFH	Intermediate_epidermis
i3_intact_S2_bcCYFL	Intermediate_epidermis
i3_intact_S2_bcCYGD	Intermediate_epidermis
i3_intact_S2_bcCYKA	Epidermal_Langerhans
i3_intact_S2_bcCYMT	Intermediate_epidermis
i3_intact_S2_bcCYPL	Tcells
i3_intact_S2_bcCYWU	Intermediate_epidermis
i3_intact_S2_bcCYYJ	BasalEpidermis
i3_intact_S2_bcCZAE	Intermediate_epidermis
i3_intact_S2_bcCZAU	Tcells
i3_intact_S2_bcCZDC	BasalEpidermis
i3_intact_S2_bcCZDT	Intermediate_epidermis
i3_intact_S2_bcCZLK	Proliferating_Epidermis
i3_intact_S2_bcCZMY	Intermediate_epidermis
i3_intact_S2_bcCZQF	Intermediate_epidermis
i3_intact_S2_bcCZRQ	Tcells
i3_intact_S2_bcCZSF	Proliferating_Epidermis
i3_intact_S2_bcCZSI	Intermediate_epidermis
i3_intact_S2_bcCZUC	Intermediate_epidermis
i3_intact_S2_bcCZVU	Intermediate_epidermis
i3_intact_S2_bcCZVZ	SSCs
i3_intact_S2_bcCZWE	SSCs
i3_intact_S2_bcCZYF	Early_B
i3_intact_S2_bcCZZP	Intermediate_epidermis
i3_intact_S2_bcDADB	Intermediate_epidermis
i3_intact_S2_bcDADT	Epidermal_Langerhans
i3_intact_S2_bcDAFA	Proliferating_Epidermis
i3_intact_S2_bcDAGH	BasalEpidermis
i3_intact_S2_bcDAGU	Intermediate_epidermis
i3_intact_S2_bcDAHO	Intermediate_epidermis
i3_intact_S2_bcDAKE	BasalEpidermis
i3_intact_S2_bcDAKY	Intermediate_epidermis
i3_intact_S2_bcDALI	Intermediate_epidermis
i3_intact_S2_bcDASW	Intermediate_epidermis
i3_intact_S2_bcDAUJ	Intermediate_epidermis
i3_intact_S2_bcDAXN	Intermediate_epidermis
i3_intact_S2_bcDAXT	Myeloid
i3_intact_S2_bcDAYT	Intermediate_epidermis
i3_intact_S2_bcDAZT	Intermediate_epidermis
i3_intact_S2_bcDBBV	Intermediate_epidermis
i3_intact_S2_bcDBDY	Intermediate_epidermis
i3_intact_S2_bcDBGB	Intermediate_epidermis
i3_intact_S2_bcDBHM	Tcells
i3_intact_S2_bcDBKA	Intermediate_epidermis
i3_intact_S2_bcDBKW	Myeloid
i3_intact_S2_bcDBLB	Intermediate_epidermis
i3_intact_S2_bcDBLP	BasalEpidermis
i3_intact_S2_bcDBPY	Intermediate_epidermis
i3_intact_S2_bcDBQX	Intermediate_epidermis
i3_intact_S2_bcDBRP	Intermediate_epidermis
i3_intact_S2_bcDBSW	Intermediate_epidermis
i3_intact_S2_bcDBVV	Intermediate_epidermis
i3_intact_S2_bcDBVX	Intermediate_epidermis
i3_intact_S2_bcDBXP	Erythrocyte
i3_intact_S2_bcDBYD	Proliferating_Epidermis
i3_intact_S2_bcDBYF	Intermediate_epidermis
i3_intact_S2_bcDBYT	SSCs
i3_intact_S2_bcDBZJ	Intermediate_epidermis
i3_intact_S2_bcDBZS	Intermediate_epidermis
i3_intact_S2_bcDCCA	Epidermal_Langerhans
i3_intact_S2_bcDCFB	Intermediate_epidermis
i3_intact_S2_bcDCFW	Intermediate_epidermis
i3_intact_S2_bcDCHH	Intermediate_epidermis
i3_intact_S2_bcDCJO	Intermediate_epidermis
i3_intact_S2_bcDCJT	Fibroblast
i3_intact_S2_bcDCJV	Proliferating_Epidermis
i3_intact_S2_bcDCLR	Proliferating_Epidermis
i3_intact_S2_bcDCLU	Proliferating_Epidermis
i3_intact_S2_bcDCLZ	Intermediate_epidermis
i3_intact_S2_bcDCRG	Intermediate_epidermis
i3_intact_S2_bcDCVG	Intermediate_epidermis
i3_intact_S2_bcDCVN	Tcells
i3_intact_S2_bcDDCH	Intermediate_epidermis
i3_intact_S2_bcDDFF	Intermediate_epidermis
i3_intact_S2_bcDDFH	Intermediate_epidermis
i3_intact_S2_bcDDGI	Intermediate_epidermis
i3_intact_S2_bcDDGW	Intermediate_epidermis
i3_intact_S2_bcDDLH	Tcells
i3_intact_S2_bcDDOR	Intermediate_epidermis
i3_intact_S2_bcDDRT	Tcells
i3_intact_S2_bcDDSQ	Intermediate_epidermis
i3_intact_S2_bcDDSU	Proliferating_Epidermis
i3_intact_S2_bcDDUL	Intermediate_epidermis
i3_intact_S2_bcDDWU	Epidermal_Langerhans
i3_intact_S2_bcDDZQ	Intermediate_epidermis
i3_intact_S2_bcDDZX	Myeloid
i3_intact_S2_bcDECH	BasalEpidermis
i3_intact_S2_bcDEFU	Intermediate_epidermis
i3_intact_S2_bcDEGQ	BasalEpidermis
i3_intact_S2_bcDEJG	Intermediate_epidermis
i3_intact_S2_bcDELH	Intermediate_epidermis
i3_intact_S2_bcDEML	Tcells
i3_intact_S2_bcDENN	Intermediate_epidermis
i3_intact_S2_bcDENW	Intermediate_epidermis
i3_intact_S2_bcDEPX	Intermediate_epidermis
i3_intact_S2_bcDEQV	Tcells
i3_intact_S2_bcDERB	Intermediate_epidermis
i3_intact_S2_bcDESY	Epidermal_Langerhans
i3_intact_S2_bcDETM	Fibroblast
i3_intact_S2_bcDEXN	Intermediate_epidermis
i3_intact_S2_bcDFAB	Intermediate_epidermis
i3_intact_S2_bcDFBE	Intermediate_epidermis
i3_intact_S2_bcDFCJ	Intermediate_epidermis
i3_intact_S2_bcDFFC	Intermediate_epidermis
i3_intact_S2_bcDFOB	Intermediate_epidermis
i3_intact_S2_bcDFOV	SSCs
i3_intact_S2_bcDFPV	Intermediate_epidermis
i3_intact_S2_bcDFQS	Tcells
i3_intact_S2_bcDFUW	SSCs
i3_intact_S2_bcDFWS	Intermediate_epidermis
i3_intact_S2_bcDFXZ	SSCs
i3_intact_S2_bcDFZM	BasalEpidermis
i3_intact_S2_bcDGBT	Intermediate_epidermis
i3_intact_S2_bcDGDT	Intermediate_epidermis
i3_intact_S2_bcDGEL	Intermediate_epidermis
i3_intact_S2_bcDGGB	Tcells
i3_intact_S2_bcDGLI	Epidermal_Langerhans
i3_intact_S2_bcDGLJ	Intermediate_epidermis
i3_intact_S2_bcDGLL	Intermediate_epidermis
i3_intact_S2_bcDGMG	Ionocytes
i3_intact_S2_bcDGMR	Tcells
i3_intact_S2_bcDGNF	Intermediate_epidermis
i3_intact_S2_bcDGNN	Proliferating_Epidermis
i3_intact_S2_bcDGPC	BasalEpidermis
i3_intact_S2_bcDGRE	SSCs
i3_intact_S2_bcDGYR	Fibroblast
i3_intact_S2_bcDHCU	Intermediate_epidermis
i3_intact_S2_bcDHDL	Intermediate_epidermis
i3_intact_S2_bcDHEA	SSCs
i3_intact_S2_bcDHJN	Intermediate_epidermis
i3_intact_S2_bcDHOX	Intermediate_epidermis
i3_intact_S2_bcDHRQ	Intermediate_epidermis
i3_intact_S2_bcDHTW	Erythrocyte
i3_intact_S2_bcDHVF	Intermediate_epidermis
i3_intact_S2_bcDHWY	Intermediate_epidermis
i3_intact_S2_bcDHYY	Intermediate_epidermis
i3_intact_S2_bcDHZW	Intermediate_epidermis
i3_intact_S2_bcDIGA	Proliferating_Epidermis
i3_intact_S2_bcDIHY	Fibroblast
i3_intact_S2_bcDIKF	Intermediate_epidermis
i3_intact_S2_bcDISE	Intermediate_epidermis
i3_intact_S2_bcDITD	Intermediate_epidermis
i3_intact_S2_bcDITL	Intermediate_epidermis
i3_intact_S2_bcDIYZ	Intermediate_epidermis
i3_intact_S2_bcDJBL	Intermediate_epidermis
i3_intact_S2_bcDJDB	Intermediate_epidermis
i3_intact_S2_bcDJDJ	Intermediate_epidermis
i3_intact_S2_bcDJEI	Intermediate_epidermis
i3_intact_S2_bcDJGY	Tcells
i3_intact_S2_bcDJHG	Intermediate_epidermis
i3_intact_S2_bcDJKS	Intermediate_epidermis
i3_intact_S2_bcDJMH	Fibroblast
i3_intact_S2_bcDJNW	Erythrocyte
i3_intact_S2_bcDJOK	Intermediate_epidermis
i3_intact_S2_bcDJVA	BasalEpidermis
i3_intact_S2_bcDJVC	BasalEpidermis
i3_intact_S2_bcDJZQ	SSCs
i3_intact_S2_bcDKBH	Intermediate_epidermis
i3_intact_S2_bcDKCA	Intermediate_epidermis
i3_intact_S2_bcDKCC	Fibroblast
i3_intact_S2_bcDKCW	Intermediate_epidermis
i3_intact_S2_bcDKDV	Intermediate_epidermis
i3_intact_S2_bcDKEX	Tcells
i3_intact_S2_bcDKGD	Erythrocyte
i3_intact_S2_bcDKHL	Intermediate_epidermis
i3_intact_S2_bcDKJD	Intermediate_epidermis
i3_intact_S2_bcDKKV	BasalEpidermis
i3_intact_S2_bcDKTH	Intermediate_epidermis
i3_intact_S2_bcDKXG	Intermediate_epidermis
i3_intact_S2_bcDLBG	Intermediate_epidermis
i3_intact_S2_bcDLHC	Intermediate_epidermis
i3_intact_S2_bcDLHJ	Epidermal_Langerhans
i3_intact_S2_bcDLIE	Epidermal_Langerhans
i3_intact_S2_bcDLNM	Proliferating_Epidermis
i3_intact_S2_bcDLPH	Tcells
i3_intact_S2_bcDLQI	Intermediate_epidermis
i3_intact_S2_bcDLRG	Intermediate_epidermis
i3_intact_S2_bcDLUE	Intermediate_epidermis
i3_intact_S2_bcDLZE	Proliferating_Epidermis
i3_intact_S2_bcDMCX	SSCs
i3_intact_S2_bcDMDO	Intermediate_epidermis
i3_intact_S2_bcDMDW	Intermediate_epidermis
i3_intact_S2_bcDMFD	Intermediate_epidermis
i3_intact_S2_bcDMFT	Intermediate_epidermis
i3_intact_S2_bcDMGH	Intermediate_epidermis
i3_intact_S2_bcDMGK	Intermediate_epidermis
i3_intact_S2_bcDMGV	Tcells
i3_intact_S2_bcDMHL	Intermediate_epidermis
i3_intact_S2_bcDMJH	Tcells
i3_intact_S2_bcDMKP	Tcells
i3_intact_S2_bcDMMU	Intermediate_epidermis
i3_intact_S2_bcDMUX	Intermediate_epidermis
i3_intact_S2_bcDMYD	Tcells
i3_intact_S2_bcDNAC	Intermediate_epidermis
i3_intact_S2_bcDNAL	SSCs
i3_intact_S2_bcDNDS	Tcells
i3_intact_S2_bcDNGN	Intermediate_epidermis
i3_intact_S2_bcDNLA	Tcells
i3_intact_S2_bcDNLR	Intermediate_epidermis
i3_intact_S2_bcDNMD	Fibroblast
i3_intact_S2_bcDNNE	Intermediate_epidermis
i3_intact_S2_bcDNNG	Intermediate_epidermis
i3_intact_S2_bcDNOZ	Intermediate_epidermis
i3_intact_S2_bcDNUM	Intermediate_epidermis
i3_intact_S2_bcDNVL	Intermediate_epidermis
i3_intact_S2_bcDNWI	SSCs
i3_intact_S2_bcDNWS	Intermediate_epidermis
i3_intact_S2_bcDNYG	SSCs
i3_intact_S2_bcDOBT	Myeloid
i3_intact_S2_bcDOCA	Myeloid
i3_intact_S2_bcDOCO	Intermediate_epidermis
i3_intact_S2_bcDODW	Tcells
i3_intact_S2_bcDOEV	Intermediate_epidermis
i3_intact_S2_bcDOOL	Early_B
i3_intact_S2_bcDORN	Intermediate_epidermis
i3_intact_S2_bcDORT	Intermediate_epidermis
i3_intact_S2_bcDOVT	Intermediate_epidermis
i3_intact_S2_bcDPFH	Intermediate_epidermis
i3_intact_S2_bcDPGJ	Fibroblast
i3_intact_S2_bcDPIR	Tcells
i3_intact_S2_bcDPMQ	Proliferating_Epidermis
i3_intact_S2_bcDPOR	Intermediate_epidermis
i3_intact_S2_bcDPRT	Proliferating_Epidermis
i3_intact_S2_bcDPSE	Proliferating_Epidermis
i3_intact_S2_bcDPTZ	Proliferating_Epidermis
i3_intact_S2_bcDPVI	SSCs
i3_intact_S2_bcDPWI	Intermediate_epidermis
i3_intact_S2_bcDPWS	Intermediate_epidermis
i3_intact_S2_bcDPXF	Intermediate_epidermis
i3_intact_S2_bcDQAW	Erythrocyte
i3_intact_S2_bcDQBX	Proliferating_Epidermis
i3_intact_S2_bcDQCB	BasalEpidermis
i3_intact_S2_bcDQCX	Proliferating_Epidermis
i3_intact_S2_bcDQEZ	SSCs
i3_intact_S2_bcDQJI	BasalEpidermis
i3_intact_S2_bcDQKN	Fibroblast
i3_intact_S2_bcDQLB	Intermediate_epidermis
i3_intact_S2_bcDQQX	Intermediate_epidermis
i3_intact_S2_bcDQSK	Tcells
i3_intact_S2_bcDQUP	Myeloid
i3_intact_S2_bcDQVE	Intermediate_epidermis
i3_intact_S2_bcDQVM	Intermediate_epidermis
i3_intact_S2_bcDQYI	Intermediate_epidermis
i3_intact_S2_bcDQZP	Tcells
i3_intact_S2_bcDRCC	Intermediate_epidermis
i3_intact_S2_bcDRCZ	SSCs
i3_intact_S2_bcDREU	Intermediate_epidermis
i3_intact_S2_bcDRGS	Intermediate_epidermis
i3_intact_S2_bcDRGW	SSCs
i3_intact_S2_bcDRIX	Intermediate_epidermis
i3_intact_S2_bcDRON	Intermediate_epidermis
i3_intact_S2_bcDRRI	Intermediate_epidermis
i3_intact_S2_bcDRSE	Intermediate_epidermis
i3_intact_S2_bcDRTW	SSCs
i3_intact_S2_bcDRVG	Intermediate_epidermis
i3_intact_S2_bcDRXR	BasalEpidermis
i3_intact_S2_bcDRZR	Myeloid
i3_intact_S2_bcDSDC	SSCs
i3_intact_S2_bcDSDG	Intermediate_epidermis
i3_intact_S2_bcDSIM	Erythrocyte
i3_intact_S2_bcDSJR	Intermediate_epidermis
i3_intact_S2_bcDSLX	Intermediate_epidermis
i3_intact_S2_bcDSPF	SSCs
i3_intact_S2_bcDSPW	Intermediate_epidermis
i3_intact_S2_bcDSQY	Intermediate_epidermis
i3_intact_S2_bcDSTO	Intermediate_epidermis
i3_intact_S2_bcDSUE	Proliferating_Epidermis
i3_intact_S2_bcDSUQ	Intermediate_epidermis
i3_intact_S2_bcDSWL	Intermediate_epidermis
i3_intact_S2_bcDSWR	Intermediate_epidermis
i3_intact_S2_bcDSXA	Intermediate_epidermis
i3_intact_S2_bcDTCF	Epidermal_Langerhans
i3_intact_S2_bcDTDS	Intermediate_epidermis
i3_intact_S2_bcDTDZ	Intermediate_epidermis
i3_intact_S2_bcDTGN	BasalEpidermis
i3_intact_S2_bcDTGX	Tcells
i3_intact_S2_bcDTJC	Intermediate_epidermis
i3_intact_S2_bcDTJU	Intermediate_epidermis
i3_intact_S2_bcDTMF	Intermediate_epidermis
i3_intact_S2_bcDTPX	Proliferating_Epidermis
i3_intact_S2_bcDTQY	Intermediate_epidermis
i3_intact_S2_bcDTRL	Intermediate_epidermis
i3_intact_S2_bcDTTC	Tcells
i3_intact_S2_bcDTWC	Tcells
i3_intact_S2_bcDUBD	Intermediate_epidermis
i3_intact_S2_bcDUBJ	Intermediate_epidermis
i3_intact_S2_bcDUDX	Tcells
i3_intact_S2_bcDUEK	SSCs
i3_intact_S2_bcDUGX	Intermediate_epidermis
i3_intact_S2_bcDUHP	SSCs
i3_intact_S2_bcDUIC	Intermediate_epidermis
i3_intact_S2_bcDUIK	Intermediate_epidermis
i3_intact_S2_bcDUJE	Intermediate_epidermis
i3_intact_S2_bcDUKC	BasalEpidermis
i3_intact_S2_bcDUKY	Intermediate_epidermis
i3_intact_S2_bcDUMQ	Intermediate_epidermis
i3_intact_S2_bcDUQJ	Intermediate_epidermis
i3_intact_S2_bcDURS	Intermediate_epidermis
i3_intact_S2_bcDUSM	Intermediate_epidermis
i3_intact_S2_bcDUSQ	Intermediate_epidermis
i3_intact_S2_bcDUZX	Intermediate_epidermis
i3_intact_S2_bcDVCL	Early_B
i3_intact_S2_bcDVGV	Tcells
i3_intact_S2_bcDVHB	Proliferating_Epidermis
i3_intact_S2_bcDVHX	Intermediate_epidermis
i3_intact_S2_bcDVKC	Intermediate_epidermis
i3_intact_S2_bcDVKI	Intermediate_epidermis
i3_intact_S2_bcDVLV	Intermediate_epidermis
i3_intact_S2_bcDVSZ	Intermediate_epidermis
i3_intact_S2_bcDVTG	Intermediate_epidermis
i3_intact_S2_bcDVVT	SSCs
i3_intact_S2_bcDVZD	SSCs
i3_intact_S2_bcDWAR	Tcells
i3_intact_S2_bcDWKY	Intermediate_epidermis
i3_intact_S2_bcDWLX	Myeloid
i3_intact_S2_bcDWMI	Intermediate_epidermis
i3_intact_S2_bcDWQO	Intermediate_epidermis
i3_intact_S2_bcDWTL	Intermediate_epidermis
i3_intact_S2_bcDWUW	Intermediate_epidermis
i3_intact_S2_bcDXGD	Intermediate_epidermis
i3_intact_S2_bcDXGF	Proliferating_Epidermis
i3_intact_S2_bcDXIX	Erythrocyte
i3_intact_S2_bcDXKV	Intermediate_epidermis
i3_intact_S2_bcDXMI	Intermediate_epidermis
i3_intact_S2_bcDXMQ	Intermediate_epidermis
i3_intact_S2_bcDXMS	BasalEpidermis
i3_intact_S2_bcDXOB	Intermediate_epidermis
i3_intact_S2_bcDXPJ	Intermediate_epidermis
i3_intact_S2_bcDXRM	Intermediate_epidermis
i3_intact_S2_bcDXSK	Intermediate_epidermis
i3_intact_S2_bcDXSS	SSCs
i3_intact_S2_bcDXZH	Intermediate_epidermis
i3_intact_S2_bcDYBC	Tcells
i3_intact_S2_bcDYFP	Intermediate_epidermis
i3_intact_S2_bcDYGD	BasalEpidermis
i3_intact_S2_bcDYKT	Intermediate_epidermis
i3_intact_S2_bcDYPE	Myeloid
i3_intact_S2_bcDYTG	Tcells
i3_intact_S2_bcDZHJ	Intermediate_epidermis
i3_intact_S2_bcDZKJ	Intermediate_epidermis
i3_intact_S2_bcDZPW	Tcells
i3_intact_S2_bcDZRY	Intermediate_epidermis
i3_intact_S2_bcDZXT	Intermediate_epidermis
i3_intact_S2_bcEACF	Intermediate_epidermis
i3_intact_S2_bcEAET	Intermediate_epidermis
i3_intact_S2_bcEANJ	Intermediate_epidermis
i3_intact_S2_bcEAOD	Intermediate_epidermis
i3_intact_S2_bcEAQK	Intermediate_epidermis
i3_intact_S2_bcEAZB	Intermediate_epidermis
i3_intact_S2_bcEBCJ	Intermediate_epidermis
i3_intact_S2_bcEBDU	Intermediate_epidermis
i3_intact_S2_bcEBFT	Fibroblast
i3_intact_S2_bcEBHD	Intermediate_epidermis
i3_intact_S2_bcEBNC	Intermediate_epidermis
i3_intact_S2_bcEBSB	Intermediate_epidermis
i3_intact_S2_bcEBSH	Intermediate_epidermis
i3_intact_S2_bcEBTP	Intermediate_epidermis
i3_intact_S2_bcEBTS	Intermediate_epidermis
i3_intact_S2_bcEBVI	Intermediate_epidermis
i3_intact_S2_bcEBZZ	Intermediate_epidermis
i3_intact_S2_bcECBU	Intermediate_epidermis
i3_intact_S2_bcECDD	Intermediate_epidermis
i3_intact_S2_bcECEB	Intermediate_epidermis
i3_intact_S2_bcECIH	SSCs
i3_intact_S2_bcECJA	Intermediate_epidermis
i3_intact_S2_bcECZY	Intermediate_epidermis
i3_intact_S2_bcEDDI	Fibroblast
i3_intact_S2_bcEDJE	Intermediate_epidermis
i3_intact_S2_bcEDMH	SSCs
i3_intact_S2_bcEDMW	SSCs
i3_intact_S2_bcEDNS	SSCs
i3_intact_S2_bcEDRY	Intermediate_epidermis
i3_intact_S2_bcEDUC	Intermediate_epidermis
i3_intact_S2_bcEDVT	BasalEpidermis
i3_intact_S2_bcEDYE	Intermediate_epidermis
i3_intact_S2_bcEEAY	Intermediate_epidermis
i3_intact_S2_bcEEFC	Intermediate_epidermis
i3_intact_S2_bcEEGA	Intermediate_epidermis
i3_intact_S2_bcEEGN	Tcells
i3_intact_S2_bcEEGR	Intermediate_epidermis
i3_intact_S2_bcEEIA	Tcells
i3_intact_S2_bcEEJZ	Intermediate_epidermis
i3_intact_S2_bcEEPS	Intermediate_epidermis
i3_intact_S2_bcEERO	Tcells
i3_intact_S2_bcEEWS	Intermediate_epidermis
i3_intact_S2_bcEEWZ	Intermediate_epidermis
i3_intact_S2_bcEEZO	SSCs
i3_intact_S2_bcEFGC	Intermediate_epidermis
i3_intact_S2_bcEFLG	Intermediate_epidermis
i3_intact_S2_bcEFMN	Intermediate_epidermis
i3_intact_S2_bcEFNP	Intermediate_epidermis
i3_intact_S2_bcEFNY	Intermediate_epidermis
i3_intact_S2_bcEFOA	Myeloid
i3_intact_S2_bcEFOC	Epidermal_Langerhans
i3_intact_S2_bcEFRY	SSCs
i3_intact_S2_bcEFSU	Intermediate_epidermis
i3_intact_S2_bcEFUW	Intermediate_epidermis
i3_intact_S2_bcEFVY	Tcells
i3_intact_S2_bcEFZE	Intermediate_epidermis
i3_intact_S2_bcEGAY	Intermediate_epidermis
i3_intact_S2_bcEGBY	Proliferating_Epidermis
i3_intact_S2_bcEGCE	Tcells
i3_intact_S2_bcEGCJ	Myeloid
i3_intact_S2_bcEGCU	SSCs
i3_intact_S2_bcEGEE	Intermediate_epidermis
i3_intact_S2_bcEGHD	Intermediate_epidermis
i3_intact_S2_bcEGHU	Intermediate_epidermis
i3_intact_S2_bcEGIA	Tcells
i3_intact_S2_bcEGIW	Intermediate_epidermis
i3_intact_S2_bcEGJS	Tcells
i3_intact_S2_bcEGKS	Tcells
i3_intact_S2_bcEGQD	Intermediate_epidermis
i3_intact_S2_bcEGTB	Tcells
i3_intact_S2_bcEGUW	BasalEpidermis
i3_intact_S2_bcEGVM	SSCs
i3_intact_S2_bcEGWT	Intermediate_epidermis
i3_intact_S2_bcEGWW	Tcells
i3_intact_S2_bcEGXM	Intermediate_epidermis
i3_intact_S2_bcEGYG	Intermediate_epidermis
i3_intact_S2_bcEHBX	Tcells
i3_intact_S2_bcEHDU	Intermediate_epidermis
i3_intact_S2_bcEHDX	Tcells
i3_intact_S2_bcEHFD	BasalEpidermis
i3_intact_S2_bcEHFK	Intermediate_epidermis
i3_intact_S2_bcEHLY	SSCs
i3_intact_S2_bcEHMS	Epidermal_Langerhans
i3_intact_S2_bcEHOG	Intermediate_epidermis
i3_intact_S2_bcEHPD	Intermediate_epidermis
i3_intact_S2_bcEHPS	SSCs
i3_intact_S2_bcEHRS	Intermediate_epidermis
i3_intact_S2_bcEHVN	Intermediate_epidermis
i3_intact_S2_bcEHWK	Intermediate_epidermis
i3_intact_S2_bcEHXV	Intermediate_epidermis
i3_intact_S2_bcEHZX	Intermediate_epidermis
i3_intact_S2_bcEICB	Fibroblast
i3_intact_S2_bcEILU	Proliferating_Epidermis
i3_intact_S2_bcEINL	SSCs
i3_intact_S2_bcEIUB	Intermediate_epidermis
i3_intact_S2_bcEIUM	Intermediate_epidermis
i3_intact_S2_bcEIVB	Intermediate_epidermis
i3_intact_S2_bcEIZH	Intermediate_epidermis
i3_intact_S2_bcEIZK	Intermediate_epidermis
i3_intact_S2_bcEJAK	Myeloid
i3_intact_S2_bcEJBK	Intermediate_epidermis
i3_intact_S2_bcEJDD	Myeloid
i3_intact_S2_bcEJJF	Intermediate_epidermis
i3_intact_S2_bcEJJR	Intermediate_epidermis
i3_intact_S2_bcEJNI	Intermediate_epidermis
i3_intact_S2_bcEJSI	Intermediate_epidermis
i3_intact_S2_bcEJTA	Proliferating_Epidermis
i3_intact_S2_bcEJTE	Intermediate_epidermis
i3_intact_S2_bcEJXN	Intermediate_epidermis
i3_intact_S2_bcEJZR	Intermediate_epidermis
i3_intact_S2_bcEKBQ	Proliferating_Epidermis
i3_intact_S2_bcEKDM	Intermediate_epidermis
i3_intact_S2_bcEKEU	Early_B
i3_intact_S2_bcEKGH	Intermediate_epidermis
i3_intact_S2_bcEKGZ	Intermediate_epidermis
i3_intact_S2_bcEKHB	Intermediate_epidermis
i3_intact_S2_bcEKHE	Intermediate_epidermis
i3_intact_S2_bcEKJD	Tcells
i3_intact_S2_bcEKJW	Intermediate_epidermis
i3_intact_S2_bcEKLO	Intermediate_epidermis
i3_intact_S2_bcEKNE	Intermediate_epidermis
i3_intact_S2_bcEKPL	Tcells
i3_intact_S2_bcEKRG	Erythrocyte
i3_intact_S2_bcEKUF	Tcells
i3_intact_S2_bcEKVP	Intermediate_epidermis
i3_intact_S2_bcEKWA	Tcells
i3_intact_S2_bcEKZU	Erythrocyte
i3_intact_S2_bcEKZV	Intermediate_epidermis
i3_intact_S2_bcELCZ	Erythrocyte
i3_intact_S2_bcELFC	Intermediate_epidermis
i3_intact_S2_bcELPA	Intermediate_epidermis
i3_intact_S2_bcELQO	Intermediate_epidermis
i3_intact_S2_bcELRQ	Proliferating_Epidermis
i3_intact_S2_bcELSF	Intermediate_epidermis
i3_intact_S2_bcELXG	Tcells
i3_intact_S2_bcELYV	Intermediate_epidermis
i3_intact_S2_bcEMCL	Intermediate_epidermis
i3_intact_S2_bcEMCT	BasalEpidermis
i3_intact_S2_bcEMDC	BasalEpidermis
i3_intact_S2_bcEMDV	Intermediate_epidermis
i3_intact_S2_bcEMDX	SSCs
i3_intact_S2_bcEMEW	Intermediate_epidermis
i3_intact_S2_bcEMFX	Intermediate_epidermis
i3_intact_S2_bcEMGX	Intermediate_epidermis
i3_intact_S2_bcEMHP	Intermediate_epidermis
i3_intact_S2_bcEMJR	Intermediate_epidermis
i3_intact_S2_bcEMKR	Intermediate_epidermis
i3_intact_S2_bcEMNO	Intermediate_epidermis
i3_intact_S2_bcEMNP	Intermediate_epidermis
i3_intact_S2_bcEMOT	Tcells
i3_intact_S2_bcEMQL	Intermediate_epidermis
i3_intact_S2_bcEMRK	Proliferating_Epidermis
i3_intact_S2_bcEMTS	Intermediate_epidermis
i3_intact_S2_bcEMUM	Tcells
i3_intact_S2_bcEMVK	Intermediate_epidermis
i3_intact_S2_bcENDS	Intermediate_epidermis
i3_intact_S2_bcENDT	SSCs
i3_intact_S2_bcENGJ	Intermediate_epidermis
i3_intact_S2_bcENHA	Proliferating_Epidermis
i3_intact_S2_bcENHH	Intermediate_epidermis
i3_intact_S2_bcENHW	Fibroblast
i3_intact_S2_bcENID	Ionocytes
i3_intact_S2_bcENLV	Intermediate_epidermis
i3_intact_S2_bcENMR	Tcells
i3_intact_S2_bcENPM	Intermediate_epidermis
i3_intact_S2_bcENPT	Intermediate_epidermis
i3_intact_S2_bcENQK	Intermediate_epidermis
i3_intact_S2_bcENST	BasalEpidermis
i3_intact_S2_bcENVE	Intermediate_epidermis
i3_intact_S2_bcENWM	Erythrocyte
i3_intact_S2_bcENXD	Epidermal_Langerhans
i3_intact_S2_bcENYT	BasalEpidermis
i3_intact_S2_bcENZC	Tcells
i3_intact_S2_bcEOAX	Tcells
i3_intact_S2_bcEOBX	Intermediate_epidermis
i3_intact_S2_bcEOBY	SSCs
i3_intact_S2_bcEOGL	Intermediate_epidermis
i3_intact_S2_bcEOHK	Intermediate_epidermis
i3_intact_S2_bcEOLM	SSCs
i3_intact_S2_bcEONI	Intermediate_epidermis
i3_intact_S2_bcEOOC	SSCs
i3_intact_S2_bcEOPG	Intermediate_epidermis
i3_intact_S2_bcEOUK	Intermediate_epidermis
i3_intact_S2_bcEOUN	Intermediate_epidermis
i3_intact_S2_bcEOXT	Intermediate_epidermis
i3_intact_S2_bcEPCI	Intermediate_epidermis
i3_intact_S2_bcEPEY	Intermediate_epidermis
i3_intact_S2_bcEPGP	Intermediate_epidermis
i3_intact_S2_bcEPJK	Intermediate_epidermis
i3_intact_S2_bcEPJR	Erythrocyte
i3_intact_S2_bcEPJX	Tcells
i3_intact_S2_bcEPKN	Intermediate_epidermis
i3_intact_S2_bcEPKZ	SSCs
i3_intact_S2_bcEPOZ	Proliferating_Epidermis
i3_intact_S2_bcEPQX	Intermediate_epidermis
i3_intact_S2_bcEPRA	SSCs
i3_intact_S2_bcEPTG	Intermediate_epidermis
i3_intact_S2_bcEQBC	Intermediate_epidermis
i3_intact_S2_bcEQDE	Intermediate_epidermis
i3_intact_S2_bcEQDW	Intermediate_epidermis
i3_intact_S2_bcEQGD	Intermediate_epidermis
i3_intact_S2_bcEQGU	Intermediate_epidermis
i3_intact_S2_bcEQLW	Proliferating_Epidermis
i3_intact_S2_bcEQOU	Proliferating_Epidermis
i3_intact_S2_bcEQOX	Intermediate_epidermis
i3_intact_S2_bcEQPD	Intermediate_epidermis
i3_intact_S2_bcEQPQ	Intermediate_epidermis
i3_intact_S2_bcEQQC	Tcells
i3_intact_S2_bcEQRS	Intermediate_epidermis
i3_intact_S2_bcEQSN	Intermediate_epidermis
i3_intact_S2_bcEQTX	BasalEpidermis
i3_intact_S2_bcEQUC	Intermediate_epidermis
i3_intact_S2_bcEQUK	Intermediate_epidermis
i3_intact_S2_bcEQWK	Intermediate_epidermis
i3_intact_S2_bcEQXT	Epidermal_Langerhans
i3_intact_S2_bcEQYW	Intermediate_epidermis
i3_intact_S2_bcERAD	Intermediate_epidermis
i3_intact_S2_bcERBL	Intermediate_epidermis
i3_intact_S2_bcERCC	Intermediate_epidermis
i3_intact_S2_bcERCM	Intermediate_epidermis
i3_intact_S2_bcERHB	Intermediate_epidermis
i3_intact_S2_bcERHN	Tcells
i3_intact_S2_bcERJM	SSCs
i3_intact_S2_bcEROR	Tcells
i3_intact_S2_bcERQV	Intermediate_epidermis
i3_intact_S2_bcERYP	Intermediate_epidermis
i3_intact_S2_bcESAB	SSCs
i3_intact_S2_bcESBA	Intermediate_epidermis
i3_intact_S2_bcESBE	Intermediate_epidermis
i3_intact_S2_bcESDZ	Intermediate_epidermis
i3_intact_S2_bcESER	Intermediate_epidermis
i3_intact_S2_bcESEY	Proliferating_Epidermis
i3_intact_S2_bcESGP	Intermediate_epidermis
i3_intact_S2_bcESHR	Proliferating_Epidermis
i3_intact_S2_bcESIJ	Intermediate_epidermis
i3_intact_S2_bcESIK	Intermediate_epidermis
i3_intact_S2_bcESIV	Intermediate_epidermis
i3_intact_S2_bcESLS	Intermediate_epidermis
i3_intact_S2_bcESMM	Intermediate_epidermis
i3_intact_S2_bcESNS	Proliferating_Epidermis
i3_intact_S2_bcESNZ	Intermediate_epidermis
i3_intact_S2_bcESTM	SSCs
i3_intact_S2_bcESVD	Intermediate_epidermis
i3_intact_S2_bcETAT	Proliferating_Epidermis
i3_intact_S2_bcETFN	SSCs
i3_intact_S2_bcETGJ	Tcells
i3_intact_S2_bcETIK	SSCs
i3_intact_S2_bcETOZ	Tcells
i3_intact_S2_bcETVG	SSCs
i3_intact_S2_bcEUAS	Proliferating_Epidermis
i3_intact_S2_bcEUDP	Intermediate_epidermis
i3_intact_S2_bcEUGH	Intermediate_epidermis
i3_intact_S2_bcEUHU	Tcells
i3_intact_S2_bcEUKF	Intermediate_epidermis
i3_intact_S2_bcEULL	Tcells
i3_intact_S2_bcEUMC	Ionocytes
i3_intact_S2_bcEUMF	Intermediate_epidermis
i3_intact_S2_bcEUNC	Intermediate_epidermis
i3_intact_S2_bcEUNX	SSCs
i3_intact_S2_bcEUQY	Intermediate_epidermis
i3_intact_S2_bcEUSQ	Tcells
i3_intact_S2_bcEUVD	Intermediate_epidermis
i3_intact_S2_bcEUYO	Intermediate_epidermis
i3_intact_S2_bcEVIG	Intermediate_epidermis
i3_intact_S2_bcEVOW	Tcells
i3_intact_S2_bcEVRA	SSCs
i3_intact_S2_bcEVSG	Intermediate_epidermis
i3_intact_S2_bcEVUU	Intermediate_epidermis
i3_intact_S2_bcEVZB	Intermediate_epidermis
i3_intact_S2_bcEVZC	Tcells
i3_intact_S2_bcEVZW	Intermediate_epidermis
i3_intact_S2_bcEWAP	Intermediate_epidermis
i3_intact_S2_bcEWBF	Intermediate_epidermis
i3_intact_S2_bcEWBN	Intermediate_epidermis
i3_intact_S2_bcEWBV	BasalEpidermis
i3_intact_S2_bcEWFT	Proliferating_Epidermis
i3_intact_S2_bcEWIN	Intermediate_epidermis
i3_intact_S2_bcEWIV	Intermediate_epidermis
i3_intact_S2_bcEWJK	Intermediate_epidermis
i3_intact_S2_bcEWKQ	Intermediate_epidermis
i3_intact_S2_bcEWLN	Tcells
i3_intact_S2_bcEWMN	Intermediate_epidermis
i3_intact_S2_bcEWOP	Intermediate_epidermis
i3_intact_S2_bcEWSB	Tcells
i3_intact_S2_bcEWUX	Intermediate_epidermis
i3_intact_S2_bcEWYH	Intermediate_epidermis
i3_intact_S2_bcEXAB	Intermediate_epidermis
i3_intact_S2_bcEXCF	Intermediate_epidermis
i3_intact_S2_bcEXCS	Intermediate_epidermis
i3_intact_S2_bcEXGL	Intermediate_epidermis
i3_intact_S2_bcEXJI	Intermediate_epidermis
i3_intact_S2_bcEXMG	Intermediate_epidermis
i3_intact_S2_bcEXMJ	SSCs
i3_intact_S2_bcEXPC	Intermediate_epidermis
i3_intact_S2_bcEXXU	Proliferating_Epidermis
i3_intact_S2_bcEXYK	Intermediate_epidermis
i3_intact_S2_bcEXYO	Intermediate_epidermis
i3_intact_S2_bcEYBQ	Intermediate_epidermis
i3_intact_S2_bcEYDD	Intermediate_epidermis
i3_intact_S2_bcEYLC	Intermediate_epidermis
i3_intact_S2_bcEYLM	Intermediate_epidermis
i3_intact_S2_bcEYLQ	Tcells
i3_intact_S2_bcEYMS	SSCs
i3_intact_S2_bcEYPQ	Intermediate_epidermis
i3_intact_S2_bcEYPZ	Early_B
i3_intact_S2_bcEYTH	Intermediate_epidermis
i3_intact_S2_bcEYXM	Proliferating_Epidermis
i3_intact_S2_bcEZBX	Proliferating_Epidermis
i3_intact_S2_bcEZFV	Intermediate_epidermis
i3_intact_S2_bcEZGB	Intermediate_epidermis
i3_intact_S2_bcEZLE	SSCs
i3_intact_S2_bcEZMM	Tcells
i3_intact_S2_bcEZNR	Fibroblast
i3_intact_S2_bcEZOL	Intermediate_epidermis
i3_intact_S2_bcEZTK	BasalEpidermis
i3_intact_S2_bcEZVM	Intermediate_epidermis
i3_intact_S2_bcEZWE	Intermediate_epidermis
i3_intact_S2_bcEZYK	Intermediate_epidermis
i3_intact_S2_bcEZYV	Intermediate_epidermis
i3_intact_S2_bcEZZW	Intermediate_epidermis
i3_intact_S2_bcFAAI	Epidermal_Langerhans
i3_intact_S2_bcFAEA	Epidermal_Langerhans
i3_intact_S2_bcFAFX	Intermediate_epidermis
i3_intact_S2_bcFAGL	Intermediate_epidermis
i3_intact_S2_bcFAIQ	SSCs
i3_intact_S2_bcFAIR	Intermediate_epidermis
i3_intact_S2_bcFALC	Proliferating_Epidermis
i3_intact_S2_bcFALE	Intermediate_epidermis
i3_intact_S2_bcFAND	Intermediate_epidermis
i3_intact_S2_bcFAOA	SSCs
i3_intact_S2_bcFATV	SSCs
i3_intact_S2_bcFAUS	Intermediate_epidermis
i3_intact_S2_bcFAZX	Intermediate_epidermis
i3_intact_S2_bcFBBP	Proliferating_Epidermis
i3_intact_S2_bcFBJG	SSCs
i3_intact_S2_bcFBLT	SSCs
i3_intact_S2_bcFBMB	Intermediate_epidermis
i3_intact_S2_bcFBPC	Tcells
i3_intact_S2_bcFBVQ	Intermediate_epidermis
i3_intact_S2_bcFCBZ	Proliferating_Epidermis
i3_intact_S2_bcFCEI	Proliferating_Epidermis
i3_intact_S2_bcFCFW	SSCs
i3_intact_S2_bcFCHR	Intermediate_epidermis
i3_intact_S2_bcFCIB	Intermediate_epidermis
i3_intact_S2_bcFCIJ	BasalEpidermis
i3_intact_S2_bcFCKX	Proliferating_Epidermis
i3_intact_S2_bcFCLH	Fibroblast
i3_intact_S2_bcFCLJ	Erythrocyte
i3_intact_S2_bcFCOD	Intermediate_epidermis
i3_intact_S2_bcFCON	Intermediate_epidermis
i3_intact_S2_bcFCQU	Intermediate_epidermis
i3_intact_S2_bcFCRD	Intermediate_epidermis
i3_intact_S2_bcFCRF	Fibroblast
i3_intact_S2_bcFCTF	Intermediate_epidermis
i3_intact_S2_bcFCUV	Intermediate_epidermis
i3_intact_S2_bcFCYR	Intermediate_epidermis
i3_intact_S2_bcFDCC	Intermediate_epidermis
i3_intact_S2_bcFDCL	Intermediate_epidermis
i3_intact_S2_bcFDHT	Epidermal_Langerhans
i3_intact_S2_bcFDIZ	Intermediate_epidermis
i3_intact_S2_bcFDJH	SSCs
i3_intact_S2_bcFDKP	Tcells
i3_intact_S2_bcFDLY	Tcells
i3_intact_S2_bcFDOP	Tcells
i3_intact_S2_bcFDOX	Intermediate_epidermis
i3_intact_S2_bcFDQW	SSCs
i3_intact_S2_bcFDRE	Intermediate_epidermis
i3_intact_S2_bcFDSV	Intermediate_epidermis
i3_intact_S2_bcFDTY	Intermediate_epidermis
i3_intact_S2_bcFEDL	Intermediate_epidermis
i3_intact_S2_bcFEDX	Intermediate_epidermis
i3_intact_S2_bcFEFB	Epidermal_Langerhans
i3_intact_S2_bcFEGZ	Tcells
i3_intact_S2_bcFEMW	Intermediate_epidermis
i3_intact_S2_bcFEOD	Intermediate_epidermis
i3_intact_S2_bcFEPG	Intermediate_epidermis
i3_intact_S2_bcFERU	Intermediate_epidermis
i3_intact_S2_bcFESP	BasalEpidermis
i3_intact_S2_bcFETE	BasalEpidermis
i3_intact_S2_bcFETX	Myeloid
i3_intact_S2_bcFEYF	Proliferating_Epidermis
i3_intact_S2_bcFEYR	Proliferating_Epidermis
i3_intact_S2_bcFEZO	Intermediate_epidermis
i3_intact_S2_bcFFAK	Proliferating_Epidermis
i3_intact_S2_bcFFAZ	Intermediate_epidermis
i3_intact_S2_bcFFCL	Tcells
i3_intact_S2_bcFFEI	Intermediate_epidermis
i3_intact_S2_bcFFGM	Intermediate_epidermis
i3_intact_S2_bcFFLM	Intermediate_epidermis
i3_intact_S2_bcFFMD	Intermediate_epidermis
i3_intact_S2_bcFFOO	BasalEpidermis
i3_intact_S2_bcFFSS	Intermediate_epidermis
i3_intact_S2_bcFFUX	Intermediate_epidermis
i3_intact_S2_bcFFWR	SSCs
i3_intact_S2_bcFFXL	Proliferating_Epidermis
i3_intact_S2_bcFGAI	Intermediate_epidermis
i3_intact_S2_bcFGAK	Intermediate_epidermis
i3_intact_S2_bcFGBO	SSCs
i3_intact_S2_bcFGER	Tcells
i3_intact_S2_bcFGIO	SSCs
i3_intact_S2_bcFGKT	Intermediate_epidermis
i3_intact_S2_bcFGON	Tcells
i3_intact_S2_bcFGQB	Proliferating_Epidermis
i3_intact_S2_bcFGQH	Intermediate_epidermis
i3_intact_S2_bcFGTF	Early_B
i3_intact_S2_bcFGTG	Epidermal_Langerhans
i3_intact_S2_bcFGTQ	Intermediate_epidermis
i3_intact_S2_bcFGWG	Intermediate_epidermis
i3_intact_S2_bcFGXD	Intermediate_epidermis
i3_intact_S2_bcFGXW	Proliferating_Epidermis
i3_intact_S2_bcFGYX	Intermediate_epidermis
i3_intact_S2_bcFHCJ	Intermediate_epidermis
i3_intact_S2_bcFHDM	SSCs
i3_intact_S2_bcFHEX	Intermediate_epidermis
i3_intact_S2_bcFHJK	Intermediate_epidermis
i3_intact_S2_bcFHKU	Tcells
i3_intact_S2_bcFHMV	Proliferating_Epidermis
i3_intact_S2_bcFHOO	Intermediate_epidermis
i3_intact_S2_bcFHOX	Tcells
i3_intact_S2_bcFHRH	Proliferating_Epidermis
i3_intact_S2_bcFICA	Intermediate_epidermis
i3_intact_S2_bcFIDZ	Intermediate_epidermis
i3_intact_S2_bcFIED	Proliferating_Epidermis
i3_intact_S2_bcFIEM	Tcells
i3_intact_S2_bcFIIM	Proliferating_Epidermis
i3_intact_S2_bcFILK	Intermediate_epidermis
i3_intact_S2_bcFILO	Tcells
i3_intact_S2_bcFIPC	Myeloid
i3_intact_S2_bcFISC	Intermediate_epidermis
i3_intact_S2_bcFIXD	Intermediate_epidermis
i3_intact_S2_bcFIXG	Intermediate_epidermis
i3_intact_S2_bcFIYC	Intermediate_epidermis
i3_intact_S2_bcFJCX	SSCs
i3_intact_S2_bcFJEQ	SSCs
i3_intact_S2_bcFJFK	Intermediate_epidermis
i3_intact_S2_bcFJHU	Intermediate_epidermis
i3_intact_S2_bcFJKT	Intermediate_epidermis
i3_intact_S2_bcFJLY	Intermediate_epidermis
i3_intact_S2_bcFJLZ	Intermediate_epidermis
i3_intact_S2_bcFJMN	SSCs
i3_intact_S2_bcFJMO	Intermediate_epidermis
i3_intact_S2_bcFJMZ	Intermediate_epidermis
i3_intact_S2_bcFJPI	SSCs
i3_intact_S2_bcFJPX	Tcells
i3_intact_S2_bcFJQO	Intermediate_epidermis
i3_intact_S2_bcFJTM	Intermediate_epidermis
i3_intact_S2_bcFJUG	Intermediate_epidermis
i3_intact_S2_bcFJVX	Intermediate_epidermis
i3_intact_S2_bcFJWP	Tcells
i3_intact_S2_bcFJXM	Intermediate_epidermis
i3_intact_S2_bcFJZA	Intermediate_epidermis
i3_intact_S2_bcFKBQ	Intermediate_epidermis
i3_intact_S2_bcFKFD	Proliferating_Epidermis
i3_intact_S2_bcFKGQ	Intermediate_epidermis
i3_intact_S2_bcFKIA	Intermediate_epidermis
i3_intact_S2_bcFKIE	Intermediate_epidermis
i3_intact_S2_bcFKIV	Intermediate_epidermis
i3_intact_S2_bcFKJT	Myeloid
i3_intact_S2_bcFKOL	Intermediate_epidermis
i3_intact_S2_bcFKQZ	Tcells
i3_intact_S2_bcFKRC	Intermediate_epidermis
i3_intact_S2_bcFKRM	SSCs
i3_intact_S2_bcFKYN	Intermediate_epidermis
i3_intact_S2_bcFLAH	Intermediate_epidermis
i3_intact_S2_bcFLCJ	Erythrocyte
i3_intact_S2_bcFLCT	Intermediate_epidermis
i3_intact_S2_bcFLDW	Intermediate_epidermis
i3_intact_S2_bcFLFI	Intermediate_epidermis
i3_intact_S2_bcFLGJ	BasalEpidermis
i3_intact_S2_bcFLGX	Intermediate_epidermis
i3_intact_S2_bcFLLD	Intermediate_epidermis
i3_intact_S2_bcFLLV	Proliferating_Epidermis
i3_intact_S2_bcFLMY	Myeloid
i3_intact_S2_bcFLOU	SSCs
i3_intact_S2_bcFLPD	Intermediate_epidermis
i3_intact_S2_bcFLVG	Proliferating_Epidermis
i3_intact_S2_bcFLVU	Intermediate_epidermis
i3_intact_S2_bcFLYR	Intermediate_epidermis
i3_intact_S2_bcFLZC	Intermediate_epidermis
i3_intact_S2_bcFMBB	Intermediate_epidermis
i3_intact_S2_bcFMEF	Intermediate_epidermis
i3_intact_S2_bcFMEO	Fibroblast
i3_intact_S2_bcFMJP	Intermediate_epidermis
i3_intact_S2_bcFMPG	Intermediate_epidermis
i3_intact_S2_bcFMQB	Myeloid
i3_intact_S2_bcFMRE	Tcells
i3_intact_S2_bcFMRM	Intermediate_epidermis
i3_intact_S2_bcFMRT	Proliferating_Epidermis
i3_intact_S2_bcFMTP	Intermediate_epidermis
i3_intact_S2_bcFMUC	Epidermal_Langerhans
i3_intact_S2_bcFMVT	Intermediate_epidermis
i3_intact_S2_bcFNBG	SSCs
i3_intact_S2_bcFNFX	Intermediate_epidermis
i3_intact_S2_bcFNGH	Intermediate_epidermis
i3_intact_S2_bcFNGY	Intermediate_epidermis
i3_intact_S2_bcFNHQ	Ionocytes
i3_intact_S2_bcFNID	Myeloid
i3_intact_S2_bcFNIG	Proliferating_Epidermis
i3_intact_S2_bcFNIO	Intermediate_epidermis
i3_intact_S2_bcFNIT	Proliferating_Epidermis
i3_intact_S2_bcFNOJ	Intermediate_epidermis
i3_intact_S2_bcFNOR	SSCs
i3_intact_S2_bcFNOW	Epidermal_Langerhans
i3_intact_S2_bcFNPL	Erythrocyte
i3_intact_S2_bcFNRV	Tcells
i3_intact_S2_bcFNUB	Intermediate_epidermis
i3_intact_S2_bcFNUY	SSCs
i3_intact_S2_bcFNWX	Myeloid
i3_intact_S2_bcFNXB	Intermediate_epidermis
i3_intact_S2_bcFOAX	Intermediate_epidermis
i3_intact_S2_bcFOBH	Intermediate_epidermis
i3_intact_S2_bcFOCQ	Intermediate_epidermis
i3_intact_S2_bcFODJ	Intermediate_epidermis
i3_intact_S2_bcFOFI	Intermediate_epidermis
i3_intact_S2_bcFOFY	Intermediate_epidermis
i3_intact_S2_bcFOIC	Intermediate_epidermis
i3_intact_S2_bcFOIO	Intermediate_epidermis
i3_intact_S2_bcFOJH	Intermediate_epidermis
i3_intact_S2_bcFOMA	Intermediate_epidermis
i3_intact_S2_bcFOMD	Intermediate_epidermis
i3_intact_S2_bcFOOM	Intermediate_epidermis
i3_intact_S2_bcFORA	Intermediate_epidermis
i3_intact_S2_bcFORT	Intermediate_epidermis
i3_intact_S2_bcFOTZ	Intermediate_epidermis
i3_intact_S2_bcFOYA	Intermediate_epidermis
i3_intact_S2_bcFPAE	Intermediate_epidermis
i3_intact_S2_bcFPFL	Intermediate_epidermis
i3_intact_S2_bcFPIH	Tcells
i3_intact_S2_bcFPKW	Epidermal_Langerhans
i3_intact_S2_bcFPLM	Myeloid
i3_intact_S2_bcFPNH	SSCs
i3_intact_S2_bcFPPJ	Proliferating_Epidermis
i3_intact_S2_bcFPVY	Intermediate_epidermis
i3_intact_S2_bcFPXP	Intermediate_epidermis
i3_intact_S2_bcFQAK	Erythrocyte
i3_intact_S2_bcFQBA	Intermediate_epidermis
i3_intact_S2_bcFQES	Intermediate_epidermis
i3_intact_S2_bcFQJU	Intermediate_epidermis
i3_intact_S2_bcFQLL	Proliferating_Epidermis
i3_intact_S2_bcFQPX	Proliferating_Epidermis
i3_intact_S2_bcFQQO	Intermediate_epidermis
i3_intact_S2_bcFQQS	BasalEpidermis
i3_intact_S2_bcFQSZ	Intermediate_epidermis
i3_intact_S2_bcFQWD	Intermediate_epidermis
i3_intact_S2_bcFQYB	Ionocytes
i3_intact_S2_bcFRAP	Epidermal_Langerhans
i3_intact_S2_bcFRKJ	Intermediate_epidermis
i3_intact_S2_bcFRKV	Intermediate_epidermis
i3_intact_S2_bcFRMS	Proliferating_Epidermis
i3_intact_S2_bcFRWI	Intermediate_epidermis
i3_intact_S2_bcFRXE	Intermediate_epidermis
i3_intact_S2_bcFRZZ	Intermediate_epidermis
i3_intact_S2_bcFSAJ	Intermediate_epidermis
i3_intact_S2_bcFSAX	BasalEpidermis
i3_intact_S2_bcFSBE	Intermediate_epidermis
i3_intact_S2_bcFSBW	Myeloid
i3_intact_S2_bcFSDM	Intermediate_epidermis
i3_intact_S2_bcFSEH	Intermediate_epidermis
i3_intact_S2_bcFSEL	Proliferating_Epidermis
i3_intact_S2_bcFSEU	SSCs
i3_intact_S2_bcFSFN	Intermediate_epidermis
i3_intact_S2_bcFSGA	Proliferating_Epidermis
i3_intact_S2_bcFSIG	SSCs
i3_intact_S2_bcFSMH	Intermediate_epidermis
i3_intact_S2_bcFSQP	Tcells
i3_intact_S2_bcFSRE	Intermediate_epidermis
i3_intact_S2_bcFSSE	Intermediate_epidermis
i3_intact_S2_bcFSXY	Epidermal_Langerhans
i3_intact_S2_bcFSZT	SSCs
i3_intact_S2_bcFTAZ	SSCs
i3_intact_S2_bcFTCJ	Intermediate_epidermis
i3_intact_S2_bcFTIF	Intermediate_epidermis
i3_intact_S2_bcFTRR	Fibroblast
i3_intact_S2_bcFTSF	Tcells
i3_intact_S2_bcFUAG	Intermediate_epidermis
i3_intact_S2_bcFUAU	Tcells
i3_intact_S2_bcFUBJ	Intermediate_epidermis
i3_intact_S2_bcFUEA	SSCs
i3_intact_S2_bcFUFF	Intermediate_epidermis
i3_intact_S2_bcFUGG	Intermediate_epidermis
i3_intact_S2_bcFUGH	Fibroblast
i3_intact_S2_bcFUGJ	Intermediate_epidermis
i3_intact_S2_bcFUIA	Intermediate_epidermis
i3_intact_S2_bcFUIK	Tcells
i3_intact_S2_bcFUKF	Intermediate_epidermis
i3_intact_S2_bcFUPP	Intermediate_epidermis
i3_intact_S2_bcFUQC	SSCs
i3_intact_S2_bcFUQE	Intermediate_epidermis
i3_intact_S2_bcFUQW	BasalEpidermis
i3_intact_S2_bcFURI	Intermediate_epidermis
i3_intact_S2_bcFUWQ	Tcells
i3_intact_S2_bcFUXL	Intermediate_epidermis
i3_intact_S2_bcFUXO	BasalEpidermis
i3_intact_S2_bcFVBX	Tcells
i3_intact_S2_bcFVCY	BasalEpidermis
i3_intact_S2_bcFVDF	SSCs
i3_intact_S2_bcFVIU	SSCs
i3_intact_S2_bcFVMO	Intermediate_epidermis
i3_intact_S2_bcFVQN	Intermediate_epidermis
i3_intact_S2_bcFVRF	Intermediate_epidermis
i3_intact_S2_bcFVRL	BasalEpidermis
i3_intact_S2_bcFVRP	Intermediate_epidermis
i3_intact_S2_bcFVSP	Intermediate_epidermis
i3_intact_S2_bcFVTP	Intermediate_epidermis
i3_intact_S2_bcFVXG	Erythrocyte
i3_intact_S2_bcFWAS	Intermediate_epidermis
i3_intact_S2_bcFWAY	Intermediate_epidermis
i3_intact_S2_bcFWBA	Erythrocyte
i3_intact_S2_bcFWIT	Intermediate_epidermis
i3_intact_S2_bcFWLG	Intermediate_epidermis
i3_intact_S2_bcFWMF	Intermediate_epidermis
i3_intact_S2_bcFWOT	Intermediate_epidermis
i3_intact_S2_bcFWPT	Intermediate_epidermis
i3_intact_S2_bcFWQN	Proliferating_Epidermis
i3_intact_S2_bcFWQQ	Intermediate_epidermis
i3_intact_S2_bcFWUP	Intermediate_epidermis
i3_intact_S2_bcFWVW	Intermediate_epidermis
i3_intact_S2_bcFXFY	Intermediate_epidermis
i3_intact_S2_bcFXGS	Proliferating_Epidermis
i3_intact_S2_bcFXGY	Intermediate_epidermis
i3_intact_S2_bcFXKX	Intermediate_epidermis
i3_intact_S2_bcFXMF	Epidermal_Langerhans
i3_intact_S2_bcFXNV	Tcells
i3_intact_S2_bcFXOA	Intermediate_epidermis
i3_intact_S2_bcFXQU	Tcells
i3_intact_S2_bcFXRD	Intermediate_epidermis
i3_intact_S2_bcFXRR	Intermediate_epidermis
i3_intact_S2_bcFXUJ	Proliferating_Epidermis
i3_intact_S2_bcFXVP	Intermediate_epidermis
i3_intact_S2_bcFXXI	SSCs
i3_intact_S2_bcFXZN	Proliferating_Epidermis
i3_intact_S2_bcFXZS	BasalEpidermis
i3_intact_S2_bcFYBE	Intermediate_epidermis
i3_intact_S2_bcFYBV	SSCs
i3_intact_S2_bcFYDQ	Intermediate_epidermis
i3_intact_S2_bcFYGG	Intermediate_epidermis
i3_intact_S2_bcFYOQ	Intermediate_epidermis
i3_intact_S2_bcFYOW	Intermediate_epidermis
i3_intact_S2_bcFYOY	Tcells
i3_intact_S2_bcFYQG	Intermediate_epidermis
i3_intact_S2_bcFYQL	Intermediate_epidermis
i3_intact_S2_bcFYQM	Tcells
i3_intact_S2_bcFYSI	Tcells
i3_intact_S2_bcFYVU	Intermediate_epidermis
i3_intact_S2_bcFYWD	Intermediate_epidermis
i3_intact_S2_bcFYWU	Intermediate_epidermis
i3_intact_S2_bcFYXY	Intermediate_epidermis
i3_intact_S2_bcFYZX	BasalEpidermis
i3_intact_S2_bcFZAI	Proliferating_Epidermis
i3_intact_S2_bcFZAO	Intermediate_epidermis
i3_intact_S2_bcFZDT	Tcells
i3_intact_S2_bcFZFJ	Erythrocyte
i3_intact_S2_bcFZFM	Tcells
i3_intact_S2_bcFZGG	Intermediate_epidermis
i3_intact_S2_bcFZHH	Intermediate_epidermis
i3_intact_S2_bcFZHM	Intermediate_epidermis
i3_intact_S2_bcFZJP	Fibroblast
i3_intact_S2_bcFZKU	Intermediate_epidermis
i3_intact_S2_bcFZLA	Intermediate_epidermis
i3_intact_S2_bcFZLQ	Tcells
i3_intact_S2_bcFZOQ	Intermediate_epidermis
i3_intact_S2_bcFZWY	Intermediate_epidermis
i3_intact_S2_bcGABH	Intermediate_epidermis
i3_intact_S2_bcGACC	Intermediate_epidermis
i3_intact_S2_bcGACZ	Intermediate_epidermis
i3_intact_S2_bcGADN	SSCs
i3_intact_S2_bcGAEK	Intermediate_epidermis
i3_intact_S2_bcGAIR	Fibroblast
i3_intact_S2_bcGAJD	Myeloid
i3_intact_S2_bcGAKQ	SSCs
i3_intact_S2_bcGANO	Intermediate_epidermis
i3_intact_S2_bcGAPB	Intermediate_epidermis
i3_intact_S2_bcGAQU	SSCs
i3_intact_S2_bcGAQZ	Fibroblast
i3_intact_S2_bcGASW	Intermediate_epidermis
i3_intact_S2_bcGATY	Epidermal_Langerhans
i3_intact_S2_bcGAVY	Intermediate_epidermis
i3_intact_S2_bcGAYB	SSCs
i3_intact_S2_bcGBBA	Intermediate_epidermis
i3_intact_S2_bcGBBS	Tcells
i3_intact_S2_bcGBBU	Tcells
i3_intact_S2_bcGBCC	Intermediate_epidermis
i3_intact_S2_bcGBCG	Intermediate_epidermis
i3_intact_S2_bcGBDE	Intermediate_epidermis
i3_intact_S2_bcGBII	Intermediate_epidermis
i3_intact_S2_bcGBLZ	Erythrocyte
i3_intact_S2_bcGBNW	Tcells
i3_intact_S2_bcGBQG	Intermediate_epidermis
i3_intact_S2_bcGBSM	Intermediate_epidermis
i3_intact_S2_bcGCAH	SSCs
i3_intact_S2_bcGCEU	Intermediate_epidermis
i3_intact_S2_bcGCEY	SSCs
i3_intact_S2_bcGCGL	SSCs
i3_intact_S2_bcGCIW	Proliferating_Epidermis
i3_intact_S2_bcGCLC	Proliferating_Epidermis
i3_intact_S2_bcGCLF	Myeloid
i3_intact_S2_bcGCMI	SSCs
i3_intact_S2_bcGCNC	Intermediate_epidermis
i3_intact_S2_bcGCNK	Intermediate_epidermis
i3_intact_S2_bcGCOV	Intermediate_epidermis
i3_intact_S2_bcGCPY	Intermediate_epidermis
i3_intact_S2_bcGCQG	BasalEpidermis
i3_intact_S2_bcGCRH	Proliferating_Epidermis
i3_intact_S2_bcGCRJ	Intermediate_epidermis
i3_intact_S2_bcGCSS	Intermediate_epidermis
i3_intact_S2_bcGCTI	Intermediate_epidermis
i3_intact_S2_bcGCVN	Proliferating_Epidermis
i3_intact_S2_bcGCVZ	Intermediate_epidermis
i3_intact_S2_bcGDBN	Intermediate_epidermis
i3_intact_S2_bcGDCE	Intermediate_epidermis
i3_intact_S2_bcGDEX	Intermediate_epidermis
i3_intact_S2_bcGDJR	Tcells
i3_intact_S2_bcGDKI	Intermediate_epidermis
i3_intact_S2_bcGDKV	Proliferating_Epidermis
i3_intact_S2_bcGDLZ	Tcells
i3_intact_S2_bcGDQI	Tcells
i3_intact_S2_bcGDQN	Myeloid
i3_intact_S2_bcGDUC	Intermediate_epidermis
i3_intact_S2_bcGDWI	Epidermal_Langerhans
i3_intact_S2_bcGDXG	Fibroblast
i3_intact_S2_bcGDYN	Tcells
i3_intact_S2_bcGEBO	Intermediate_epidermis
i3_intact_S2_bcGEKZ	Intermediate_epidermis
i3_intact_S2_bcGEMK	Intermediate_epidermis
i3_intact_S2_bcGENA	Intermediate_epidermis
i3_intact_S2_bcGESF	Intermediate_epidermis
i3_intact_S2_bcGESI	Intermediate_epidermis
i3_intact_S2_bcGEUD	Intermediate_epidermis
i3_intact_S2_bcGEXB	Intermediate_epidermis
i3_intact_S2_bcGEYN	Proliferating_Epidermis
i3_intact_S2_bcGFAN	Intermediate_epidermis
i3_intact_S2_bcGFAZ	Intermediate_epidermis
i3_intact_S2_bcGFCI	Intermediate_epidermis
i3_intact_S2_bcGFDD	SSCs
i3_intact_S2_bcGFDQ	Intermediate_epidermis
i3_intact_S2_bcGFGE	Intermediate_epidermis
i3_intact_S2_bcGFKI	Intermediate_epidermis
i3_intact_S2_bcGFOB	Intermediate_epidermis
i3_intact_S2_bcGFOF	SSCs
i3_intact_S2_bcGFVU	Intermediate_epidermis
i3_intact_S2_bcGFXG	Intermediate_epidermis
i3_intact_S2_bcGGCD	Proliferating_Epidermis
i3_intact_S2_bcGGCF	Intermediate_epidermis
i3_intact_S2_bcGGFI	BasalEpidermis
i3_intact_S2_bcGGFW	Intermediate_epidermis
i3_intact_S2_bcGGHM	Intermediate_epidermis
i3_intact_S2_bcGGHY	Intermediate_epidermis
i3_intact_S2_bcGGIX	Intermediate_epidermis
i3_intact_S2_bcGGJX	Tcells
i3_intact_S2_bcGGKZ	Intermediate_epidermis
i3_intact_S2_bcGGMG	SSCs
i3_intact_S2_bcGGMH	BasalEpidermis
i3_intact_S2_bcGGPG	Proliferating_Epidermis
i3_intact_S2_bcGGRD	Intermediate_epidermis
i3_intact_S2_bcGGTK	Proliferating_Epidermis
i3_intact_S2_bcGGYZ	Tcells
i3_intact_S2_bcGGZG	Intermediate_epidermis
i3_intact_S2_bcGHBE	Intermediate_epidermis
i3_intact_S2_bcGHCJ	SSCs
i3_intact_S2_bcGHDB	Intermediate_epidermis
i3_intact_S2_bcGHGT	Intermediate_epidermis
i3_intact_S2_bcGHHH	Intermediate_epidermis
i3_intact_S2_bcGHJC	Intermediate_epidermis
i3_intact_S2_bcGHOA	Proliferating_Epidermis
i3_intact_S2_bcGHSK	Tcells
i3_intact_S2_bcGHSU	Intermediate_epidermis
i3_intact_S2_bcGHUT	Proliferating_Epidermis
i3_intact_S2_bcGHVP	Proliferating_Epidermis
i3_intact_S2_bcGHVR	BasalEpidermis
i3_intact_S2_bcGHWU	Tcells
i3_intact_S2_bcGHWW	Intermediate_epidermis
i3_intact_S2_bcGHXX	BasalEpidermis
i3_intact_S2_bcGIAG	Intermediate_epidermis
i3_intact_S2_bcGIDT	Intermediate_epidermis
i3_intact_S2_bcGIKC	Intermediate_epidermis
i3_intact_S2_bcGIOM	Proliferating_Epidermis
i3_intact_S2_bcGIOS	Intermediate_epidermis
i3_intact_S2_bcGIOW	Intermediate_epidermis
i3_intact_S2_bcGIPH	Intermediate_epidermis
i3_intact_S2_bcGIQS	Intermediate_epidermis
i3_intact_S2_bcGIRI	Intermediate_epidermis
i3_intact_S2_bcGIUL	BasalEpidermis
i3_intact_S2_bcGIVJ	Tcells
i3_intact_S2_bcGIYR	Intermediate_epidermis
i3_intact_S2_bcGIZC	SSCs
i3_intact_S2_bcGJBP	SSCs
i3_intact_S2_bcGJCN	Intermediate_epidermis
i3_intact_S2_bcGJHT	Intermediate_epidermis
i3_intact_S2_bcGJPT	Intermediate_epidermis
i3_intact_S2_bcGJSN	Intermediate_epidermis
i3_intact_S2_bcGJVT	Intermediate_epidermis
i3_intact_S2_bcGKBH	Intermediate_epidermis
i3_intact_S2_bcGKGF	Intermediate_epidermis
i3_intact_S2_bcGKHR	Intermediate_epidermis
i3_intact_S2_bcGKJA	Intermediate_epidermis
i3_intact_S2_bcGKNY	Intermediate_epidermis
i3_intact_S2_bcGKOU	SSCs
i3_intact_S2_bcGKSW	Proliferating_Epidermis
i3_intact_S2_bcGLAE	Erythrocyte
i3_intact_S2_bcGLAL	Intermediate_epidermis
i3_intact_S2_bcGLDP	SSCs
i3_intact_S2_bcGLGO	Tcells
i3_intact_S2_bcGLJE	SSCs
i3_intact_S2_bcGLJN	Tcells
i3_intact_S2_bcGLKY	Intermediate_epidermis
i3_intact_S2_bcGLTD	Intermediate_epidermis
i3_intact_S2_bcGLTR	SSCs
i3_intact_S2_bcGLVF	SSCs
i3_intact_S2_bcGLWT	Intermediate_epidermis
i3_intact_S2_bcGLYM	Proliferating_Epidermis
i3_intact_S2_bcGLZE	Intermediate_epidermis
i3_intact_S2_bcGMAC	SSCs
i3_intact_S2_bcGMAM	Intermediate_epidermis
i3_intact_S2_bcGMCZ	Intermediate_epidermis
i3_intact_S2_bcGMFH	Epidermal_Langerhans
i3_intact_S2_bcGMHL	Intermediate_epidermis
i3_intact_S2_bcGMLL	Intermediate_epidermis
i3_intact_S2_bcGMLN	Intermediate_epidermis
i3_intact_S2_bcGMLW	Tcells
i3_intact_S2_bcGMNO	Intermediate_epidermis
i3_intact_S2_bcGMOF	BasalEpidermis
i3_intact_S2_bcGMPO	Intermediate_epidermis
i3_intact_S2_bcGMSA	Intermediate_epidermis
i3_intact_S2_bcGMTR	Tcells
i3_intact_S2_bcGMVD	Intermediate_epidermis
i3_intact_S2_bcGMWS	Erythrocyte
i3_intact_S2_bcGMXV	Erythrocyte
i3_intact_S2_bcGMYM	Intermediate_epidermis
i3_intact_S2_bcGMZC	Intermediate_epidermis
i3_intact_S2_bcGMZD	Intermediate_epidermis
i3_intact_S2_bcGNAF	Intermediate_epidermis
i3_intact_S2_bcGNBJ	Intermediate_epidermis
i3_intact_S2_bcGNCR	Intermediate_epidermis
i3_intact_S2_bcGNDN	Tcells
i3_intact_S2_bcGNDY	SSCs
i3_intact_S2_bcGNGY	BasalEpidermis
i3_intact_S2_bcGNJM	SSCs
i3_intact_S2_bcGNMA	SSCs
i3_intact_S2_bcGNSY	Intermediate_epidermis
i3_intact_S2_bcGNTG	BasalEpidermis
i3_intact_S2_bcGNWD	BasalEpidermis
i3_intact_S2_bcGNWO	Intermediate_epidermis
i3_intact_S2_bcGOAP	Intermediate_epidermis
i3_intact_S2_bcGOFK	Intermediate_epidermis
i3_intact_S2_bcGOII	Ionocytes
i3_intact_S2_bcGONX	Intermediate_epidermis
i3_intact_S2_bcGOSX	Intermediate_epidermis
i3_intact_S2_bcGOTA	Intermediate_epidermis
i3_intact_S2_bcGOWW	Intermediate_epidermis
i3_intact_S2_bcGOYT	Intermediate_epidermis
i3_intact_S2_bcGOZD	Intermediate_epidermis
i3_intact_S2_bcGPDW	Intermediate_epidermis
i3_intact_S2_bcGPIT	Intermediate_epidermis
i3_intact_S2_bcGPKG	Intermediate_epidermis
i3_intact_S2_bcGPQE	Tcells
i3_intact_S2_bcGPRZ	Intermediate_epidermis
i3_intact_S2_bcGPTB	SSCs
i3_intact_S2_bcGPUM	Intermediate_epidermis
i3_intact_S2_bcGPUW	Myeloid
i3_intact_S2_bcGPVH	SSCs
i3_intact_S2_bcGPVW	Proliferating_Epidermis
i3_intact_S2_bcGPYS	Intermediate_epidermis
i3_intact_S2_bcGQFL	Intermediate_epidermis
i3_intact_S2_bcGQFS	Intermediate_epidermis
i3_intact_S2_bcGQGA	Intermediate_epidermis
i3_intact_S2_bcGQMQ	Intermediate_epidermis
i3_intact_S2_bcGQNG	Intermediate_epidermis
i3_intact_S2_bcGQQA	Intermediate_epidermis
i3_intact_S2_bcGQRK	Intermediate_epidermis
i3_intact_S2_bcGQTA	Intermediate_epidermis
i3_intact_S2_bcGQTV	BasalEpidermis
i3_intact_S2_bcGRAQ	Intermediate_epidermis
i3_intact_S2_bcGRBT	Intermediate_epidermis
i3_intact_S2_bcGRDL	Intermediate_epidermis
i3_intact_S2_bcGRFN	Intermediate_epidermis
i3_intact_S2_bcGRHD	Intermediate_epidermis
i3_intact_S2_bcGRHG	Intermediate_epidermis
i3_intact_S2_bcGRHJ	Intermediate_epidermis
i3_intact_S2_bcGRJL	Intermediate_epidermis
i3_intact_S2_bcGRKS	SSCs
i3_intact_S2_bcGRMN	BasalEpidermis
i3_intact_S2_bcGROU	SSCs
i3_intact_S2_bcGRRJ	Intermediate_epidermis
i3_intact_S2_bcGRVD	Intermediate_epidermis
i3_intact_S2_bcGRYM	Intermediate_epidermis
i3_intact_S2_bcGRZC	Intermediate_epidermis
i3_intact_S2_bcGSDA	Proliferating_Epidermis
i3_intact_S2_bcGSFY	Intermediate_epidermis
i3_intact_S2_bcGSGS	Intermediate_epidermis
i3_intact_S2_bcGSKN	Intermediate_epidermis
i3_intact_S2_bcGSMG	Intermediate_epidermis
i3_intact_S2_bcGSNR	SSCs
i3_intact_S2_bcGSTL	Intermediate_epidermis
i3_intact_S2_bcGSUS	Intermediate_epidermis
i3_intact_S2_bcGTBC	Intermediate_epidermis
i3_intact_S2_bcGTBH	Intermediate_epidermis
i3_intact_S2_bcGTCR	Tcells
i3_intact_S2_bcGTCU	Tcells
i3_intact_S2_bcGTEI	Intermediate_epidermis
i3_intact_S2_bcGTHY	Tcells
i3_intact_S2_bcGTPP	Tcells
i3_intact_S2_bcGTSC	Intermediate_epidermis
i3_intact_S2_bcGTXT	Intermediate_epidermis
i3_intact_S2_bcGUBB	Epidermal_Langerhans
i3_intact_S2_bcGUEK	Intermediate_epidermis
i3_intact_S2_bcGUEY	Intermediate_epidermis
i3_intact_S2_bcGUFM	Intermediate_epidermis
i3_intact_S2_bcGUGE	Tcells
i3_intact_S2_bcGUHB	Tcells
i3_intact_S2_bcGUKF	Intermediate_epidermis
i3_intact_S2_bcGUOD	Intermediate_epidermis
i3_intact_S2_bcGURU	Intermediate_epidermis
i3_intact_S2_bcGUSM	Intermediate_epidermis
i3_intact_S2_bcGUVB	SSCs
i3_intact_S2_bcGUXG	Tcells
i3_intact_S2_bcGVCJ	Tcells
i3_intact_S2_bcGVDH	Intermediate_epidermis
i3_intact_S2_bcGVEW	Proliferating_Epidermis
i3_intact_S2_bcGVHM	Epidermal_Langerhans
i3_intact_S2_bcGVKQ	Tcells
i3_intact_S2_bcGVMD	Intermediate_epidermis
i3_intact_S2_bcGVOP	Intermediate_epidermis
i3_intact_S2_bcGVRW	Intermediate_epidermis
i3_intact_S2_bcGVWM	Intermediate_epidermis
i3_intact_S2_bcGVWT	Intermediate_epidermis
i3_intact_S2_bcGWLH	BasalEpidermis
i3_intact_S2_bcGWLY	Intermediate_epidermis
i3_intact_S2_bcGWOD	Intermediate_epidermis
i3_intact_S2_bcGWOT	Intermediate_epidermis
i3_intact_S2_bcGWPP	Tcells
i3_intact_S2_bcGWQJ	Myeloid
i3_intact_S2_bcGWRJ	Proliferating_Epidermis
i3_intact_S2_bcGWUD	Intermediate_epidermis
i3_intact_S2_bcGWUY	Intermediate_epidermis
i3_intact_S2_bcGWVO	SSCs
i3_intact_S2_bcGWWW	Intermediate_epidermis
i3_intact_S2_bcGWZH	Intermediate_epidermis
i3_intact_S2_bcGXAU	Intermediate_epidermis
i3_intact_S2_bcGXEV	Myeloid
i3_intact_S2_bcGXGB	Intermediate_epidermis
i3_intact_S2_bcGXMA	Intermediate_epidermis
i3_intact_S2_bcGXOK	Intermediate_epidermis
i3_intact_S2_bcGXON	Intermediate_epidermis
i3_intact_S2_bcGXZC	Intermediate_epidermis
i3_intact_S2_bcGYEG	Intermediate_epidermis
i3_intact_S2_bcGYEH	SSCs
i3_intact_S2_bcGYFJ	Proliferating_Epidermis
i3_intact_S2_bcGYKC	Intermediate_epidermis
i3_intact_S2_bcGYKX	Intermediate_epidermis
i3_intact_S2_bcGYMM	Intermediate_epidermis
i3_intact_S2_bcGYOP	Tcells
i3_intact_S2_bcGYSA	Intermediate_epidermis
i3_intact_S2_bcGYSG	Intermediate_epidermis
i3_intact_S2_bcGYXD	Intermediate_epidermis
i3_intact_S2_bcGYYN	Intermediate_epidermis
i3_intact_S2_bcGYZW	SSCs
i3_intact_S2_bcGYZY	Proliferating_Epidermis
i3_intact_S2_bcGZAR	Intermediate_epidermis
i3_intact_S2_bcGZBD	BasalEpidermis
i3_intact_S2_bcGZBF	Intermediate_epidermis
i3_intact_S2_bcGZCO	Intermediate_epidermis
i3_intact_S2_bcGZGK	Erythrocyte
i3_intact_S2_bcGZJP	Myeloid
i3_intact_S2_bcGZKH	Intermediate_epidermis
i3_intact_S2_bcGZNT	Proliferating_Epidermis
i3_intact_S2_bcGZOI	Tcells
i3_intact_S2_bcGZUJ	Tcells
i3_intact_S2_bcGZWQ	Intermediate_epidermis
i3_intact_S2_bcHAAN	Intermediate_epidermis
i3_intact_S2_bcHADI	Intermediate_epidermis
i3_intact_S2_bcHAHM	SSCs
i3_intact_S2_bcHAMN	Intermediate_epidermis
i3_intact_S2_bcHAOV	Intermediate_epidermis
i3_intact_S2_bcHARV	Intermediate_epidermis
i3_intact_S2_bcHASP	Intermediate_epidermis
i3_intact_S2_bcHATW	SSCs
i3_intact_S2_bcHBCA	SSCs
i3_intact_S2_bcHBJF	Intermediate_epidermis
i3_intact_S2_bcHBNS	Intermediate_epidermis
i3_intact_S2_bcHBZA	Tcells
i3_intact_S2_bcHCCH	Intermediate_epidermis
i3_intact_S2_bcHCDQ	Myeloid
i3_intact_S2_bcHCEE	SSCs
i3_intact_S2_bcHCEZ	Intermediate_epidermis
i3_intact_S2_bcHCHE	Intermediate_epidermis
i3_intact_S2_bcHCHM	Intermediate_epidermis
i3_intact_S2_bcHCIH	SSCs
i3_intact_S2_bcHCJA	Intermediate_epidermis
i3_intact_S2_bcHCJG	Fibroblast
i3_intact_S2_bcHCKF	Intermediate_epidermis
i3_intact_S2_bcHCNT	Fibroblast
i3_intact_S2_bcHCQR	Intermediate_epidermis
i3_intact_S2_bcHCWV	Intermediate_epidermis
i3_intact_S2_bcHDBG	Myeloid
i3_intact_S2_bcHDDG	Intermediate_epidermis
i3_intact_S2_bcHDFT	Intermediate_epidermis
i3_intact_S2_bcHDJQ	Intermediate_epidermis
i3_intact_S2_bcHDMB	Tcells
i3_intact_S2_bcHDMG	Proliferating_Epidermis
i3_intact_S2_bcHDMJ	Intermediate_epidermis
i3_intact_S2_bcHDNC	Intermediate_epidermis
i3_intact_S2_bcHDOG	Intermediate_epidermis
i3_intact_S2_bcHDPT	Intermediate_epidermis
i3_intact_S2_bcHDQN	Intermediate_epidermis
i3_intact_S2_bcHDRY	Intermediate_epidermis
i3_intact_S2_bcHDUQ	Intermediate_epidermis
i3_intact_S2_bcHDVH	SSCs
i3_intact_S2_bcHDVJ	Intermediate_epidermis
i3_intact_S2_bcHDWW	Intermediate_epidermis
i3_intact_S2_bcHEDU	Intermediate_epidermis
i3_intact_S2_bcHEIT	SSCs
i3_intact_S2_bcHEJM	Ionocytes
i3_intact_S2_bcHEKZ	Ionocytes
i3_intact_S2_bcHEOR	SSCs
i3_intact_S2_bcHEQN	Proliferating_Epidermis
i3_intact_S2_bcHESP	Intermediate_epidermis
i3_intact_S2_bcHEVK	Intermediate_epidermis
i3_intact_S2_bcHFBQ	Intermediate_epidermis
i3_intact_S2_bcHFDD	Myeloid
i3_intact_S2_bcHFDZ	Intermediate_epidermis
i3_intact_S2_bcHFFN	Intermediate_epidermis
i3_intact_S2_bcHFFS	Intermediate_epidermis
i3_intact_S2_bcHFFX	Intermediate_epidermis
i3_intact_S2_bcHFKG	Proliferating_Epidermis
i3_intact_S2_bcHFLX	Intermediate_epidermis
i3_intact_S2_bcHFOG	Intermediate_epidermis
i3_intact_S2_bcHFOO	SSCs
i3_intact_S2_bcHFOR	Tcells
i3_intact_S2_bcHFPB	Intermediate_epidermis
i3_intact_S2_bcHFPQ	Intermediate_epidermis
i3_intact_S2_bcHFTP	Intermediate_epidermis
i3_intact_S2_bcHFZF	Intermediate_epidermis
i3_intact_S2_bcHFZR	SSCs
i3_intact_S2_bcHGBW	Intermediate_epidermis
i3_intact_S2_bcHGEE	Intermediate_epidermis
i3_intact_S2_bcHGIZ	Intermediate_epidermis
i3_intact_S2_bcHGJF	Intermediate_epidermis
i3_intact_S2_bcHGKL	Fibroblast
i3_intact_S2_bcHGMD	Intermediate_epidermis
i3_intact_S2_bcHGNQ	Intermediate_epidermis
i3_intact_S2_bcHGOY	SSCs
i3_intact_S2_bcHGVI	Intermediate_epidermis
i3_intact_S2_bcHGVR	Intermediate_epidermis
i3_intact_S2_bcHGXI	Tcells
i3_intact_S2_bcHGYF	Tcells
i3_intact_S2_bcHGYR	Proliferating_Epidermis
i3_intact_S2_bcHHAC	Myeloid
i3_intact_S2_bcHHAD	Proliferating_Epidermis
i3_intact_S2_bcHHAY	Intermediate_epidermis
i3_intact_S2_bcHHBF	Intermediate_epidermis
i3_intact_S2_bcHHEL	Intermediate_epidermis
i3_intact_S2_bcHHHO	Ionocytes
i3_intact_S2_bcHHJO	Proliferating_Epidermis
i3_intact_S2_bcHHJP	Intermediate_epidermis
i3_intact_S2_bcHHKY	Tcells
i3_intact_S2_bcHHPL	Intermediate_epidermis
i3_intact_S2_bcHHYR	Intermediate_epidermis
i3_intact_S2_bcHIKH	Proliferating_Epidermis
i3_intact_S2_bcHINA	Intermediate_epidermis
i3_intact_S2_bcHIPY	Intermediate_epidermis
i3_intact_S2_bcHIWQ	Proliferating_Epidermis
i3_intact_S2_bcHIZQ	Intermediate_epidermis
i3_intact_S2_bcHJDS	Intermediate_epidermis
i3_intact_S2_bcHJEU	Intermediate_epidermis
i3_intact_S2_bcHJJA	Proliferating_Epidermis
i3_intact_S2_bcHJJN	Intermediate_epidermis
i3_intact_S2_bcHJLD	Tcells
i3_intact_S2_bcHJLM	Intermediate_epidermis
i3_intact_S2_bcHJQF	Intermediate_epidermis
i3_intact_S2_bcHJUS	Erythrocyte
i3_intact_S2_bcHJWL	Intermediate_epidermis
i3_intact_S2_bcHKFE	Intermediate_epidermis
i3_intact_S2_bcHKKM	Tcells
i3_intact_S2_bcHKNA	Intermediate_epidermis
i3_intact_S2_bcHKOP	Fibroblast
i3_intact_S2_bcHKPB	Intermediate_epidermis
i3_intact_S2_bcHKPP	Intermediate_epidermis
i3_intact_S2_bcHKQB	Intermediate_epidermis
i3_intact_S2_bcHKSB	Intermediate_epidermis
i3_intact_S2_bcHKTE	Intermediate_epidermis
i3_intact_S2_bcHKVF	Early_B
i3_intact_S2_bcHLEW	Epidermal_Langerhans
i3_intact_S2_bcHLFG	Intermediate_epidermis
i3_intact_S2_bcHLFW	Tcells
i3_intact_S2_bcHLJH	Intermediate_epidermis
i3_intact_S2_bcHLKN	Tcells
i3_intact_S2_bcHLLP	BasalEpidermis
i3_intact_S2_bcHLQP	Tcells
i3_intact_S2_bcHLRZ	Tcells
i3_intact_S2_bcHLSV	Intermediate_epidermis
i3_intact_S2_bcHLTC	Intermediate_epidermis
i3_intact_S2_bcHLTF	Intermediate_epidermis
i3_intact_S2_bcHLYK	Intermediate_epidermis
i3_intact_S2_bcHMCF	Intermediate_epidermis
i3_intact_S2_bcHMDI	BasalEpidermis
i3_intact_S2_bcHMDM	Intermediate_epidermis
i3_intact_S2_bcHMLK	Tcells
i3_intact_S2_bcHMLQ	Intermediate_epidermis
i3_intact_S2_bcHMLU	Myeloid
i3_intact_S2_bcHMPA	Fibroblast
i3_intact_S2_bcHMPN	Intermediate_epidermis
i3_intact_S2_bcHMWX	Intermediate_epidermis
i3_intact_S2_bcHNFE	Intermediate_epidermis
i3_intact_S2_bcHNKP	Intermediate_epidermis
i3_intact_S2_bcHNRV	Intermediate_epidermis
i3_intact_S2_bcHNVP	Intermediate_epidermis
i3_intact_S2_bcHNWH	Myeloid
i3_intact_S2_bcHNYC	Intermediate_epidermis
i3_intact_S2_bcHOGK	Tcells
i3_intact_S2_bcHOKC	SSCs
i3_intact_S2_bcHOPJ	Intermediate_epidermis
i3_intact_S2_bcHORT	Intermediate_epidermis
i3_intact_S2_bcHOTT	Intermediate_epidermis
i3_intact_S2_bcHOVT	Intermediate_epidermis
i3_intact_S2_bcHOVX	Intermediate_epidermis
i3_intact_S2_bcHOXI	Intermediate_epidermis
i3_intact_S2_bcHPCQ	Intermediate_epidermis
i3_intact_S2_bcHPJL	Intermediate_epidermis
i3_intact_S2_bcHPLR	Intermediate_epidermis
i3_intact_S2_bcHPMG	Tcells
i3_intact_S2_bcHPOM	Intermediate_epidermis
i3_intact_S2_bcHPSM	Intermediate_epidermis
i3_intact_S2_bcHPSS	Intermediate_epidermis
i3_intact_S2_bcHPTB	Intermediate_epidermis
i3_intact_S2_bcHPUH	Intermediate_epidermis
i3_intact_S2_bcHPUX	Intermediate_epidermis
i3_intact_S2_bcHQCR	Intermediate_epidermis
i3_intact_S2_bcHQFH	Intermediate_epidermis
i3_intact_S2_bcHQJH	Intermediate_epidermis
i3_intact_S2_bcHQLI	Intermediate_epidermis
i3_intact_S2_bcHQOR	Intermediate_epidermis
i3_intact_S2_bcHQOX	Myeloid
i3_intact_S2_bcHQPL	SSCs
i3_intact_S2_bcHQTW	Intermediate_epidermis
i3_intact_S2_bcHQVX	Intermediate_epidermis
i3_intact_S2_bcHQWI	SSCs
i3_intact_S2_bcHQXR	Intermediate_epidermis
i3_intact_S2_bcHQXT	Intermediate_epidermis
i3_intact_S2_bcHQYG	Intermediate_epidermis
i3_intact_S2_bcHRAX	Intermediate_epidermis
i3_intact_S2_bcHRCJ	Intermediate_epidermis
i3_intact_S2_bcHREY	Intermediate_epidermis
i3_intact_S2_bcHRIP	Tcells
i3_intact_S2_bcHRMD	Intermediate_epidermis
i3_intact_S2_bcHRNE	Proliferating_Epidermis
i3_intact_S2_bcHRPG	Intermediate_epidermis
i3_intact_S2_bcHRUU	Intermediate_epidermis
i3_intact_S2_bcHSAP	SSCs
i3_intact_S2_bcHSCO	SSCs
i3_intact_S2_bcHSKH	Proliferating_Epidermis
i3_intact_S2_bcHSLT	Tcells
i3_intact_S2_bcHSQJ	Intermediate_epidermis
i3_intact_S2_bcHSTK	Intermediate_epidermis
i3_intact_S2_bcHTBK	Tcells
i3_intact_S2_bcHTBL	Intermediate_epidermis
i3_intact_S2_bcHTEE	Intermediate_epidermis
i3_intact_S2_bcHTIE	Erythrocyte
i3_intact_S2_bcHTJE	Intermediate_epidermis
i3_intact_S2_bcHTKN	Intermediate_epidermis
i3_intact_S2_bcHTRE	SSCs
i3_intact_S2_bcHTVO	Intermediate_epidermis
i3_intact_S2_bcHTYT	Intermediate_epidermis
i3_intact_S2_bcHUDN	Intermediate_epidermis
i3_intact_S2_bcHUIX	Intermediate_epidermis
i3_intact_S2_bcHUIY	Intermediate_epidermis
i3_intact_S2_bcHULN	Intermediate_epidermis
i3_intact_S2_bcHULY	Intermediate_epidermis
i3_intact_S2_bcHURW	Ionocytes
i3_intact_S2_bcHUWJ	Intermediate_epidermis
i3_intact_S2_bcHUWV	SSCs
i3_intact_S2_bcHVBA	Intermediate_epidermis
i3_intact_S2_bcHVDJ	Myeloid
i3_intact_S2_bcHVFF	Intermediate_epidermis
i3_intact_S2_bcHVKD	Epidermal_Langerhans
i3_intact_S2_bcHVLS	Intermediate_epidermis
i3_intact_S2_bcHVNJ	Proliferating_Epidermis
i3_intact_S2_bcHVTS	Intermediate_epidermis
i3_intact_S2_bcHVVQ	Intermediate_epidermis
i3_intact_S2_bcHVVT	Fibroblast
i3_intact_S2_bcHVWY	Proliferating_Epidermis
i3_intact_S2_bcHVXW	Intermediate_epidermis
i3_intact_S2_bcHVYU	Proliferating_Epidermis
i3_intact_S2_bcHVZU	Proliferating_Epidermis
i3_intact_S2_bcHWAN	Intermediate_epidermis
i3_intact_S2_bcHWCE	Intermediate_epidermis
i3_intact_S2_bcHWFD	BasalEpidermis
i3_intact_S2_bcHWGL	Intermediate_epidermis
i3_intact_S2_bcHWHC	Intermediate_epidermis
i3_intact_S2_bcHWHN	Epidermal_Langerhans
i3_intact_S2_bcHWHV	Intermediate_epidermis
i3_intact_S2_bcHWMT	Tcells
i3_intact_S2_bcHWSR	Intermediate_epidermis
i3_intact_S2_bcHWSU	Intermediate_epidermis
i3_intact_S2_bcHWTN	SSCs
i3_intact_S2_bcHWUJ	Intermediate_epidermis
i3_intact_S2_bcHWUM	Tcells
i3_intact_S2_bcHWWF	Erythrocyte
i3_intact_S2_bcHXCX	Intermediate_epidermis
i3_intact_S2_bcHXDR	Intermediate_epidermis
i3_intact_S2_bcHXGK	SSCs
i3_intact_S2_bcHXJA	Intermediate_epidermis
i3_intact_S2_bcHXLL	Intermediate_epidermis
i3_intact_S2_bcHXMO	BasalEpidermis
i3_intact_S2_bcHXTB	Intermediate_epidermis
i3_intact_S2_bcHXUR	Proliferating_Epidermis
i3_intact_S2_bcHYBF	Intermediate_epidermis
i3_intact_S2_bcHYDV	Intermediate_epidermis
i3_intact_S2_bcHYEO	Intermediate_epidermis
i3_intact_S2_bcHYFN	Proliferating_Epidermis
i3_intact_S2_bcHYIV	BasalEpidermis
i3_intact_S2_bcHYMB	Proliferating_Epidermis
i3_intact_S2_bcHYNP	Tcells
i3_intact_S2_bcHYNQ	Intermediate_epidermis
i3_intact_S2_bcHYNS	Intermediate_epidermis
i3_intact_S2_bcHYQY	SSCs
i3_intact_S2_bcHYRJ	Intermediate_epidermis
i3_intact_S2_bcHYWW	Tcells
i3_intact_S2_bcHYXC	Intermediate_epidermis
i3_intact_S2_bcHZDH	Intermediate_epidermis
i3_intact_S2_bcHZDJ	Ionocytes
i3_intact_S2_bcHZEA	Intermediate_epidermis
i3_intact_S2_bcHZFB	SSCs
i3_intact_S2_bcHZIX	Intermediate_epidermis
i3_intact_S2_bcHZKT	Intermediate_epidermis
i3_intact_S2_bcHZNE	Intermediate_epidermis
i3_intact_S2_bcHZOE	Intermediate_epidermis
i3_intact_S2_bcHZPP	Intermediate_epidermis
i3_intact_S2_bcHZYS	Erythrocyte
i3_intact_S2_bcIAHA	Intermediate_epidermis
i3_intact_S2_bcIAJO	Tcells
i3_intact_S2_bcIALH	Intermediate_epidermis
i3_intact_S2_bcIAMM	Myeloid
i3_intact_S2_bcIAQA	Intermediate_epidermis
i3_intact_S2_bcIASA	Intermediate_epidermis
i3_intact_S2_bcIATU	BasalEpidermis
i3_intact_S2_bcIATW	Intermediate_epidermis
i3_intact_S2_bcIAUU	Proliferating_Epidermis
i3_intact_S2_bcIAVA	Erythrocyte
i3_intact_S2_bcIAXI	Intermediate_epidermis
i3_intact_S2_bcIBAO	Intermediate_epidermis
i3_intact_S2_bcIBCF	SSCs
i3_intact_S2_bcIBCO	Intermediate_epidermis
i3_intact_S2_bcIBCU	Intermediate_epidermis
i3_intact_S2_bcIBDC	Intermediate_epidermis
i3_intact_S2_bcIBDU	Intermediate_epidermis
i3_intact_S2_bcIBOE	Proliferating_Epidermis
i3_intact_S2_bcIBQA	Myeloid
i3_intact_S2_bcIBSI	Intermediate_epidermis
i3_intact_S2_bcIBSZ	Intermediate_epidermis
i3_intact_S2_bcIBUU	Intermediate_epidermis
i3_intact_S2_bcIBUV	Proliferating_Epidermis
i3_intact_S2_bcIBZC	Intermediate_epidermis
i3_intact_S2_bcICAD	Intermediate_epidermis
i3_intact_S2_bcICAO	Myeloid
i3_intact_S2_bcICCP	Intermediate_epidermis
i3_intact_S2_bcICHN	Intermediate_epidermis
i3_intact_S2_bcICHQ	Intermediate_epidermis
i3_intact_S2_bcICJA	Tcells
i3_intact_S2_bcICLY	Intermediate_epidermis
i3_intact_S2_bcICPX	Intermediate_epidermis
i3_intact_S2_bcICQG	Intermediate_epidermis
i3_intact_S2_bcICRP	Epidermal_Langerhans
i3_intact_S2_bcICTL	Intermediate_epidermis
i3_intact_S2_bcIDGJ	Intermediate_epidermis
i3_intact_S2_bcIDVM	Intermediate_epidermis
i3_intact_S2_bcIDXB	SSCs
i3_intact_S2_bcIECY	Intermediate_epidermis
i3_intact_S2_bcIEDX	Intermediate_epidermis
i3_intact_S2_bcIEEM	Intermediate_epidermis
i3_intact_S2_bcIFBY	Intermediate_epidermis
i3_intact_S2_bcIFIS	Intermediate_epidermis
i3_intact_S2_bcIFLJ	SSCs
i3_intact_S2_bcIFWA	Intermediate_epidermis
i3_intact_S2_bcIFWV	Proliferating_Epidermis
i3_intact_S2_bcIFYL	Intermediate_epidermis
i3_intact_S2_bcIGAL	Tcells
i3_intact_S2_bcIGDK	Intermediate_epidermis
i3_intact_S2_bcIGIU	SSCs
i3_intact_S2_bcIGSU	Intermediate_epidermis
i3_intact_S2_bcIGTN	Intermediate_epidermis
i3_intact_S2_bcIGTS	Intermediate_epidermis
i3_intact_S2_bcIGVX	Ionocytes
i3_intact_S2_bcIGYY	Intermediate_epidermis
i3_intact_S2_bcIHGL	Intermediate_epidermis
i3_intact_S2_bcIHQK	Intermediate_epidermis
i3_intact_S2_bcIHQO	Intermediate_epidermis
i3_intact_S2_bcIHQU	Intermediate_epidermis
i3_intact_S2_bcIHRD	SSCs
i3_intact_S2_bcIHUD	Proliferating_Epidermis
i3_intact_S2_bcIHXW	Intermediate_epidermis
i3_intact_S2_bcIIIW	Intermediate_epidermis
i3_intact_S2_bcIIOX	Intermediate_epidermis
i3_intact_S2_bcIIPZ	Intermediate_epidermis
i3_intact_S2_bcIIQL	Intermediate_epidermis
i3_intact_S2_bcIIYN	Intermediate_epidermis
i3_intact_S2_bcIJIC	Intermediate_epidermis
i3_intact_S2_bcIJWF	Intermediate_epidermis
i3_intact_S2_bcIJXA	Intermediate_epidermis
